genome	rate	S_alg	k	d	M_alg	M_compr_alg	kmer_count	l	o	z	r	tigs_ns	tigs_cl	enc0_xz_bytes	S_xz_bytes	M_compr_bytes	enc1_compr_bytes	enc2_xz_bytes	pref
escherichia_coli.k32	0.000000001	eulertigs	31	na	default	bzip	1	31	1	30	1	1	31	96	96	41	137	96	escherichia_coli.k32.r_0.000000001.S_eulertigs.k_31.d_na.M_default.C_bzip
escherichia_coli.k32	0.000000001	eulertigs	31	na	default	xz	1	31	1	30	1	1	31	96	96	76	172	96	escherichia_coli.k32.r_0.000000001.S_eulertigs.k_31.d_na.M_default.C_xz
escherichia_coli.k32	0.000000001	eulertigs	31	na	ones	bzip	1	31	1	30	1	1	31	96	96	41	137	96	escherichia_coli.k32.r_0.000000001.S_eulertigs.k_31.d_na.M_ones.C_bzip
escherichia_coli.k32	0.000000001	eulertigs	31	na	ones	xz	1	31	1	30	1	1	31	96	96	76	172	96	escherichia_coli.k32.r_0.000000001.S_eulertigs.k_31.d_na.M_ones.C_xz
escherichia_coli.k32	0.000000001	eulertigs	31	na	runsapprox	bzip	1	31	1	30	1	1	31	96	96	41	137	96	escherichia_coli.k32.r_0.000000001.S_eulertigs.k_31.d_na.M_runsapprox.C_bzip
escherichia_coli.k32	0.000000001	eulertigs	31	na	runsapprox	xz	1	31	1	30	1	1	31	96	96	76	172	96	escherichia_coli.k32.r_0.000000001.S_eulertigs.k_31.d_na.M_runsapprox.C_xz
escherichia_coli.k32	0.0001	eulertigs	31	na	default	bzip	16229	503069	16229	486840	16228	16228	503069	142356	135924	49	135973	146512	escherichia_coli.k32.r_0.0001.S_eulertigs.k_31.d_na.M_default.C_bzip
escherichia_coli.k32	0.0001	eulertigs	31	na	default	xz	16229	503069	16229	486840	16228	16228	503069	142356	135924	224	136148	146512	escherichia_coli.k32.r_0.0001.S_eulertigs.k_31.d_na.M_default.C_xz
escherichia_coli.k32	0.0001	eulertigs	31	na	ones	bzip	16229	503069	16229	486840	16228	16228	503069	142356	135924	49	135973	146512	escherichia_coli.k32.r_0.0001.S_eulertigs.k_31.d_na.M_ones.C_bzip
escherichia_coli.k32	0.0001	eulertigs	31	na	ones	xz	16229	503069	16229	486840	16228	16228	503069	142356	135924	224	136148	146512	escherichia_coli.k32.r_0.0001.S_eulertigs.k_31.d_na.M_ones.C_xz
escherichia_coli.k32	0.0001	eulertigs	31	na	runsapprox	bzip	16229	503069	16229	486840	16228	16228	503069	142356	135924	49	135973	146512	escherichia_coli.k32.r_0.0001.S_eulertigs.k_31.d_na.M_runsapprox.C_bzip
escherichia_coli.k32	0.0001	eulertigs	31	na	runsapprox	xz	16229	503069	16229	486840	16228	16228	503069	142356	135924	224	136148	146512	escherichia_coli.k32.r_0.0001.S_eulertigs.k_31.d_na.M_runsapprox.C_xz
escherichia_coli.k32	0.001	eulertigs	31	na	default	bzip	162298	5025568	162298	4863270	162109	162109	5025568	1429288	1310292	521	1310813	1451156	escherichia_coli.k32.r_0.001.S_eulertigs.k_31.d_na.M_default.C_bzip
escherichia_coli.k32	0.001	eulertigs	31	na	default	xz	162298	5025568	162298	4863270	162109	162109	5025568	1429288	1310292	1604	1311896	1451156	escherichia_coli.k32.r_0.001.S_eulertigs.k_31.d_na.M_default.C_xz
escherichia_coli.k32	0.001	eulertigs	31	na	ones	bzip	162298	5025568	162327	4863241	162138	162109	5025568	1429288	1310292	610	1310902	1451308	escherichia_coli.k32.r_0.001.S_eulertigs.k_31.d_na.M_ones.C_bzip
escherichia_coli.k32	0.001	eulertigs	31	na	ones	xz	162298	5025568	162327	4863241	162138	162109	5025568	1429288	1310292	1788	1312080	1451308	escherichia_coli.k32.r_0.001.S_eulertigs.k_31.d_na.M_ones.C_xz
escherichia_coli.k32	0.001	eulertigs	31	na	runsapprox	bzip	162298	5025568	162327	4863241	162138	162109	5025568	1429288	1310292	610	1310902	1451308	escherichia_coli.k32.r_0.001.S_eulertigs.k_31.d_na.M_runsapprox.C_bzip
escherichia_coli.k32	0.001	eulertigs	31	na	runsapprox	xz	162298	5025568	162327	4863241	162138	162109	5025568	1429288	1310292	1788	1312080	1451308	escherichia_coli.k32.r_0.001.S_eulertigs.k_31.d_na.M_runsapprox.C_xz
escherichia_coli.k32	0.01	eulertigs	31	na	default	bzip	1622989	49814809	1622989	48191820	1606394	1606394	49814809	13592668	12468068	28940	12497008	13785812	escherichia_coli.k32.r_0.01.S_eulertigs.k_31.d_na.M_default.C_bzip
escherichia_coli.k32	0.01	eulertigs	31	na	default	xz	1622989	49814809	1622989	48191820	1606394	1606394	49814809	13592668	12468068	54288	12522356	13785812	escherichia_coli.k32.r_0.01.S_eulertigs.k_31.d_na.M_default.C_xz
escherichia_coli.k32	0.01	eulertigs	31	na	ones	bzip	1622989	49814809	1625910	48188899	1609309	1606394	49814809	13592668	12468068	34932	12503000	13788496	escherichia_coli.k32.r_0.01.S_eulertigs.k_31.d_na.M_ones.C_bzip
escherichia_coli.k32	0.01	eulertigs	31	na	ones	xz	1622989	49814809	1625910	48188899	1609309	1606394	49814809	13592668	12468068	69528	12537596	13788496	escherichia_coli.k32.r_0.01.S_eulertigs.k_31.d_na.M_ones.C_xz
escherichia_coli.k32	0.01	eulertigs	31	na	runsapprox	bzip	1622989	49814809	1625910	48188899	1609309	1606394	49814809	13592668	12468068	34932	12503000	13788496	escherichia_coli.k32.r_0.01.S_eulertigs.k_31.d_na.M_runsapprox.C_bzip
escherichia_coli.k32	0.01	eulertigs	31	na	runsapprox	xz	1622989	49814809	1625910	48188899	1609309	1606394	49814809	13592668	12468068	69528	12537596	13788496	escherichia_coli.k32.r_0.01.S_eulertigs.k_31.d_na.M_runsapprox.C_xz
escherichia_coli.k32	0.05	eulertigs	31	na	default	bzip	8114946	239218806	8114946	231103860	7703462	7703462	239218806	62501696	57026188	487340	57513528	63630552	escherichia_coli.k32.r_0.05.S_eulertigs.k_31.d_na.M_default.C_bzip
escherichia_coli.k32	0.05	eulertigs	31	na	default	xz	8114946	239218806	8114946	231103860	7703462	7703462	239218806	62501696	57026188	881020	57907208	63630552	escherichia_coli.k32.r_0.05.S_eulertigs.k_31.d_na.M_default.C_xz
escherichia_coli.k32	0.05	eulertigs	31	na	ones	bzip	8114946	239218806	8184504	231034302	7771863	7703462	239218806	62501696	57026188	600734	57626922	63664856	escherichia_coli.k32.r_0.05.S_eulertigs.k_31.d_na.M_ones.C_bzip
escherichia_coli.k32	0.05	eulertigs	31	na	ones	xz	8114946	239218806	8184504	231034302	7771863	7703462	239218806	62501696	57026188	1159192	58185380	63664856	escherichia_coli.k32.r_0.05.S_eulertigs.k_31.d_na.M_ones.C_xz
escherichia_coli.k32	0.05	eulertigs	31	na	runsapprox	bzip	8114946	239218806	8184504	231034302	7771863	7703462	239218806	62501696	57026188	600734	57626922	63664856	escherichia_coli.k32.r_0.05.S_eulertigs.k_31.d_na.M_runsapprox.C_bzip
escherichia_coli.k32	0.05	eulertigs	31	na	runsapprox	xz	8114946	239218806	8184504	231034302	7771863	7703462	239218806	62501696	57026188	1159192	58185380	63664856	escherichia_coli.k32.r_0.05.S_eulertigs.k_31.d_na.M_runsapprox.C_xz
escherichia_coli.k32	0.1	eulertigs	31	na	default	bzip	16229893	453816733	16229893	437586840	14586228	14586228	453816733	117130096	106791392	1478198	108269590	119718092	escherichia_coli.k32.r_0.1.S_eulertigs.k_31.d_na.M_default.C_bzip
escherichia_coli.k32	0.1	eulertigs	31	na	default	xz	16229893	453816733	16229893	437586840	14586228	14586228	453816733	117130096	106791392	2734372	109525764	119718092	escherichia_coli.k32.r_0.1.S_eulertigs.k_31.d_na.M_default.C_xz
escherichia_coli.k32	0.1	eulertigs	31	na	ones	bzip	16229893	453816733	16492890	437323843	14840824	14586228	453816733	117130096	106791392	1858808	108650200	119952024	escherichia_coli.k32.r_0.1.S_eulertigs.k_31.d_na.M_ones.C_bzip
escherichia_coli.k32	0.1	eulertigs	31	na	ones	xz	16229893	453816733	16492890	437323843	14840824	14586228	453816733	117130096	106791392	3603536	110394928	119952024	escherichia_coli.k32.r_0.1.S_eulertigs.k_31.d_na.M_ones.C_xz
escherichia_coli.k32	0.1	eulertigs	31	na	runsapprox	bzip	16229893	453816733	16492890	437323843	14840824	14586228	453816733	117130096	106791392	1858808	108650200	119952024	escherichia_coli.k32.r_0.1.S_eulertigs.k_31.d_na.M_runsapprox.C_bzip
escherichia_coli.k32	0.1	eulertigs	31	na	runsapprox	xz	16229893	453816733	16492890	437323843	14840824	14586228	453816733	117130096	106791392	3603536	110394928	119952024	escherichia_coli.k32.r_0.1.S_eulertigs.k_31.d_na.M_runsapprox.C_xz
escherichia_coli.k32	0.2	eulertigs	31	na	default	bzip	32459787	809702277	32459787	777242490	25908083	25908083	809702277	208456788	189730468	4156789	193887257	214530408	escherichia_coli.k32.r_0.2.S_eulertigs.k_31.d_na.M_default.C_bzip
escherichia_coli.k32	0.2	eulertigs	31	na	default	xz	32459787	809702277	32459787	777242490	25908083	25908083	809702277	208456788	189730468	7686036	197416504	214530408	escherichia_coli.k32.r_0.2.S_eulertigs.k_31.d_na.M_default.C_xz
escherichia_coli.k32	0.2	eulertigs	31	na	ones	bzip	32459787	809702277	33399732	776302545	26788023	25908083	809702277	208456788	189730468	5350613	195081081	215371188	escherichia_coli.k32.r_0.2.S_eulertigs.k_31.d_na.M_ones.C_bzip
escherichia_coli.k32	0.2	eulertigs	31	na	ones	xz	32459787	809702277	33399732	776302545	26788023	25908083	809702277	208456788	189730468	10111520	199841988	215371188	escherichia_coli.k32.r_0.2.S_eulertigs.k_31.d_na.M_ones.C_xz
escherichia_coli.k32	0.2	eulertigs	31	na	runsapprox	bzip	32459787	809702277	33399732	776302545	26788023	25908083	809702277	208456788	189730468	5350613	195081081	215371188	escherichia_coli.k32.r_0.2.S_eulertigs.k_31.d_na.M_runsapprox.C_bzip
escherichia_coli.k32	0.2	eulertigs	31	na	runsapprox	xz	32459787	809702277	33399732	776302545	26788023	25908083	809702277	208456788	189730468	10111520	199841988	215371188	escherichia_coli.k32.r_0.2.S_eulertigs.k_31.d_na.M_runsapprox.C_xz
escherichia_coli.k32	0.3	eulertigs	31	na	default	bzip	48689681	1068469661	48689681	1019779980	33992666	33992666	1068469661	276335324	251049204	7323031	258372235	286574840	escherichia_coli.k32.r_0.3.S_eulertigs.k_31.d_na.M_default.C_bzip
escherichia_coli.k32	0.3	eulertigs	31	na	default	xz	48689681	1068469661	48689681	1019779980	33992666	33992666	1068469661	276335324	251049204	13347908	264397112	286574840	escherichia_coli.k32.r_0.3.S_eulertigs.k_31.d_na.M_default.C_xz
escherichia_coli.k32	0.3	eulertigs	31	na	ones	bzip	48689681	1068469661	50551120	1017918541	35671390	33992666	1068469661	276335324	251049204	9531024	260580228	288195164	escherichia_coli.k32.r_0.3.S_eulertigs.k_31.d_na.M_ones.C_bzip
escherichia_coli.k32	0.3	eulertigs	31	na	ones	xz	48689681	1068469661	50551120	1017918541	35671390	33992666	1068469661	276335324	251049204	17328644	268377848	288195164	escherichia_coli.k32.r_0.3.S_eulertigs.k_31.d_na.M_ones.C_xz
escherichia_coli.k32	0.3	eulertigs	31	na	runsapprox	bzip	48689681	1068469661	50551120	1017918541	35671390	33992666	1068469661	276335324	251049204	9531024	260580228	288195164	escherichia_coli.k32.r_0.3.S_eulertigs.k_31.d_na.M_runsapprox.C_bzip
escherichia_coli.k32	0.3	eulertigs	31	na	runsapprox	xz	48689681	1068469661	50551120	1017918541	35671390	33992666	1068469661	276335324	251049204	17328644	268377848	288195164	escherichia_coli.k32.r_0.3.S_eulertigs.k_31.d_na.M_runsapprox.C_xz
escherichia_coli.k32	0.4	eulertigs	31	na	default	bzip	64919574	1230909834	64919574	1165990260	38866342	38866342	1230909834	319110100	289538336	10544505	300082841	333254352	escherichia_coli.k32.r_0.4.S_eulertigs.k_31.d_na.M_default.C_bzip
escherichia_coli.k32	0.4	eulertigs	31	na	default	xz	64919574	1230909834	64919574	1165990260	38866342	38866342	1230909834	319110100	289538336	18958864	308497200	333254352	escherichia_coli.k32.r_0.4.S_eulertigs.k_31.d_na.M_default.C_xz
escherichia_coli.k32	0.4	eulertigs	31	na	ones	bzip	64919574	1230909834	67781313	1163128521	41344650	38866342	1230909834	319110100	289538336	13787209	303325545	335693776	escherichia_coli.k32.r_0.4.S_eulertigs.k_31.d_na.M_ones.C_bzip
escherichia_coli.k32	0.4	eulertigs	31	na	ones	xz	64919574	1230909834	67781313	1163128521	41344650	38866342	1230909834	319110100	289538336	24145404	313683740	335693776	escherichia_coli.k32.r_0.4.S_eulertigs.k_31.d_na.M_ones.C_xz
escherichia_coli.k32	0.4	eulertigs	31	na	runsapprox	bzip	64919574	1230909834	67781313	1163128521	41344650	38866342	1230909834	319110100	289538336	13787209	303325545	335693776	escherichia_coli.k32.r_0.4.S_eulertigs.k_31.d_na.M_runsapprox.C_bzip
escherichia_coli.k32	0.4	eulertigs	31	na	runsapprox	xz	64919574	1230909834	67781313	1163128521	41344650	38866342	1230909834	319110100	289538336	24145404	313683740	335693776	escherichia_coli.k32.r_0.4.S_eulertigs.k_31.d_na.M_runsapprox.C_xz
escherichia_coli.k32	0.5	eulertigs	31	na	default	bzip	81149468	1297960058	81149468	1216810590	40560353	40560353	1297960058	337502532	306072424	13415457	319487881	355218172	escherichia_coli.k32.r_0.5.S_eulertigs.k_31.d_na.M_default.C_bzip
escherichia_coli.k32	0.5	eulertigs	31	na	default	xz	81149468	1297960058	81149468	1216810590	40560353	40560353	1297960058	337502532	306072424	23822556	329894980	355218172	escherichia_coli.k32.r_0.5.S_eulertigs.k_31.d_na.M_default.C_xz
escherichia_coli.k32	0.5	eulertigs	31	na	ones	bzip	81149468	1297960058	84924233	1213035825	43681839	40560353	1297960058	337502532	306072424	17542442	323614866	358398156	escherichia_coli.k32.r_0.5.S_eulertigs.k_31.d_na.M_ones.C_bzip
escherichia_coli.k32	0.5	eulertigs	31	na	ones	xz	81149468	1297960058	84924233	1213035825	43681839	40560353	1297960058	337502532	306072424	29643720	335716144	358398156	escherichia_coli.k32.r_0.5.S_eulertigs.k_31.d_na.M_ones.C_xz
escherichia_coli.k32	0.5	eulertigs	31	na	runsapprox	bzip	81149468	1297960058	84924233	1213035825	43681839	40560353	1297960058	337502532	306072424	17542442	323614866	358398156	escherichia_coli.k32.r_0.5.S_eulertigs.k_31.d_na.M_runsapprox.C_bzip
escherichia_coli.k32	0.5	eulertigs	31	na	runsapprox	xz	81149468	1297960058	84924233	1213035825	43681839	40560353	1297960058	337502532	306072424	29643720	335716144	358398156	escherichia_coli.k32.r_0.5.S_eulertigs.k_31.d_na.M_runsapprox.C_xz
escherichia_coli.k32	0.6	eulertigs	31	na	default	bzip	97379362	1270349632	97379362	1172970270	39099009	39099009	1270349632	332173560	301161020	15488416	316649436	352650376	escherichia_coli.k32.r_0.6.S_eulertigs.k_31.d_na.M_default.C_bzip
escherichia_coli.k32	0.6	eulertigs	31	na	default	xz	97379362	1270349632	97379362	1172970270	39099009	39099009	1270349632	332173560	301161020	27072792	328233812	352650376	escherichia_coli.k32.r_0.6.S_eulertigs.k_31.d_na.M_default.C_xz
escherichia_coli.k32	0.6	eulertigs	31	na	ones	bzip	97379362	1270349632	101818691	1168530941	42575988	39099009	1270349632	332173560	301161020	20182122	321343142	356266976	escherichia_coli.k32.r_0.6.S_eulertigs.k_31.d_na.M_ones.C_bzip
escherichia_coli.k32	0.6	eulertigs	31	na	ones	xz	97379362	1270349632	101818691	1168530941	42575988	39099009	1270349632	332173560	301161020	32926604	334087624	356266976	escherichia_coli.k32.r_0.6.S_eulertigs.k_31.d_na.M_ones.C_xz
escherichia_coli.k32	0.6	eulertigs	31	na	runsapprox	bzip	97379362	1270349632	101818691	1168530941	42575988	39099009	1270349632	332173560	301161020	20182122	321343142	356266976	escherichia_coli.k32.r_0.6.S_eulertigs.k_31.d_na.M_runsapprox.C_bzip
escherichia_coli.k32	0.6	eulertigs	31	na	runsapprox	xz	97379362	1270349632	101818691	1168530941	42575988	39099009	1270349632	332173560	301161020	32926604	334087624	356266976	escherichia_coli.k32.r_0.6.S_eulertigs.k_31.d_na.M_runsapprox.C_xz
escherichia_coli.k32	0.7	eulertigs	31	na	default	bzip	113609255	1148922635	113609255	1035313380	34510446	34510446	1148922635	301524896	273702804	16112609	289815413	323959480	escherichia_coli.k32.r_0.7.S_eulertigs.k_31.d_na.M_default.C_bzip
escherichia_coli.k32	0.7	eulertigs	31	na	default	xz	113609255	1148922635	113609255	1035313380	34510446	34510446	1148922635	301524896	273702804	27767260	301470064	323959480	escherichia_coli.k32.r_0.7.S_eulertigs.k_31.d_na.M_default.C_xz
escherichia_coli.k32	0.7	eulertigs	31	na	ones	bzip	113609255	1148922635	118317571	1030605064	37946136	34510446	1148922635	301524896	273702804	20926501	294629305	327770948	escherichia_coli.k32.r_0.7.S_eulertigs.k_31.d_na.M_ones.C_bzip
escherichia_coli.k32	0.7	eulertigs	31	na	ones	xz	113609255	1148922635	118317571	1030605064	37946136	34510446	1148922635	301524896	273702804	33126172	306828976	327770948	escherichia_coli.k32.r_0.7.S_eulertigs.k_31.d_na.M_ones.C_xz
escherichia_coli.k32	0.7	eulertigs	31	na	runsapprox	bzip	113609255	1148922635	118317571	1030605064	37946136	34510446	1148922635	301524896	273702804	20926501	294629305	327770948	escherichia_coli.k32.r_0.7.S_eulertigs.k_31.d_na.M_runsapprox.C_bzip
escherichia_coli.k32	0.7	eulertigs	31	na	runsapprox	xz	113609255	1148922635	118317571	1030605064	37946136	34510446	1148922635	301524896	273702804	33126172	306828976	327770948	escherichia_coli.k32.r_0.7.S_eulertigs.k_31.d_na.M_runsapprox.C_xz
escherichia_coli.k32	0.8	eulertigs	31	na	default	bzip	129839149	934012609	129839149	804173460	26805782	26805782	934012609	245998472	223680380	14698025	238378405	268744352	escherichia_coli.k32.r_0.8.S_eulertigs.k_31.d_na.M_default.C_bzip
escherichia_coli.k32	0.8	eulertigs	31	na	default	xz	129839149	934012609	129839149	804173460	26805782	26805782	934012609	245998472	223680380	24945624	248626004	268744352	escherichia_coli.k32.r_0.8.S_eulertigs.k_31.d_na.M_default.C_xz
escherichia_coli.k32	0.8	eulertigs	31	na	ones	bzip	129839149	934012609	134245968	799766641	29695307	26805782	934012609	245998472	223680380	19006146	242686526	272200728	escherichia_coli.k32.r_0.8.S_eulertigs.k_31.d_na.M_ones.C_bzip
escherichia_coli.k32	0.8	eulertigs	31	na	ones	xz	129839149	934012609	134245968	799766641	29695307	26805782	934012609	245998472	223680380	29322028	253002408	272200728	escherichia_coli.k32.r_0.8.S_eulertigs.k_31.d_na.M_ones.C_xz
escherichia_coli.k32	0.8	eulertigs	31	na	runsapprox	bzip	129839149	934012609	134245968	799766641	29695307	26805782	934012609	245998472	223680380	19006146	242686526	272200728	escherichia_coli.k32.r_0.8.S_eulertigs.k_31.d_na.M_runsapprox.C_bzip
escherichia_coli.k32	0.8	eulertigs	31	na	runsapprox	xz	129839149	934012609	134245968	799766641	29695307	26805782	934012609	245998472	223680380	29322028	253002408	272200728	escherichia_coli.k32.r_0.8.S_eulertigs.k_31.d_na.M_runsapprox.C_xz
escherichia_coli.k32	0.9	eulertigs	31	na	default	bzip	146069043	626408013	146069043	480338970	16011299	16011299	626408013	162853544	148883456	10539299	159422755	182431236	escherichia_coli.k32.r_0.9.S_eulertigs.k_31.d_na.M_default.C_bzip
escherichia_coli.k32	0.9	eulertigs	31	na	default	xz	146069043	626408013	146069043	480338970	16011299	16011299	626408013	162853544	148883456	17461384	166344840	182431236	escherichia_coli.k32.r_0.9.S_eulertigs.k_31.d_na.M_default.C_xz
escherichia_coli.k32	0.9	eulertigs	31	na	ones	bzip	146069043	626408013	149459118	476948895	17777877	16011299	626408013	162853544	148883456	13612409	162495865	184757732	escherichia_coli.k32.r_0.9.S_eulertigs.k_31.d_na.M_ones.C_bzip
escherichia_coli.k32	0.9	eulertigs	31	na	ones	xz	146069043	626408013	149459118	476948895	17777877	16011299	626408013	162853544	148883456	20474588	169358044	184757732	escherichia_coli.k32.r_0.9.S_eulertigs.k_31.d_na.M_ones.C_xz
escherichia_coli.k32	0.9	eulertigs	31	na	runsapprox	bzip	146069043	626408013	149459118	476948895	17777877	16011299	626408013	162853544	148883456	13612409	162495865	184757732	escherichia_coli.k32.r_0.9.S_eulertigs.k_31.d_na.M_runsapprox.C_bzip
escherichia_coli.k32	0.9	eulertigs	31	na	runsapprox	xz	146069043	626408013	149459118	476948895	17777877	16011299	626408013	162853544	148883456	20474588	169358044	184757732	escherichia_coli.k32.r_0.9.S_eulertigs.k_31.d_na.M_runsapprox.C_xz
escherichia_coli.k32	1.0	eulertigs	31	na	default	bzip	162298937	226648667	162298937	64349730	2144991	2144991	226648667	51043840	48941000	1878101	50819101	57289524	escherichia_coli.k32.r_1.0.S_eulertigs.k_31.d_na.M_default.C_bzip
escherichia_coli.k32	1.0	eulertigs	31	na	default	xz	162298937	226648667	162298937	64349730	2144991	2144991	226648667	51043840	48941000	3531828	52472828	57289524	escherichia_coli.k32.r_1.0.S_eulertigs.k_31.d_na.M_default.C_xz
escherichia_coli.k32	1.0	eulertigs	31	na	ones	bzip	162298937	226648667	163795263	62853404	2148002	2144991	226648667	51043840	48941000	2471795	51412795	57432220	escherichia_coli.k32.r_1.0.S_eulertigs.k_31.d_na.M_ones.C_bzip
escherichia_coli.k32	1.0	eulertigs	31	na	ones	xz	162298937	226648667	163795263	62853404	2148002	2144991	226648667	51043840	48941000	4245896	53186896	57432220	escherichia_coli.k32.r_1.0.S_eulertigs.k_31.d_na.M_ones.C_xz
escherichia_coli.k32	1.0	eulertigs	31	na	runsapprox	bzip	162298937	226648667	163795263	62853404	2148002	2144991	226648667	51043840	48941000	2471795	51412795	57432220	escherichia_coli.k32.r_1.0.S_eulertigs.k_31.d_na.M_runsapprox.C_bzip
escherichia_coli.k32	1.0	eulertigs	31	na	runsapprox	xz	162298937	226648667	163795263	62853404	2148002	2144991	226648667	51043840	48941000	4245896	53186896	57432220	escherichia_coli.k32.r_1.0.S_eulertigs.k_31.d_na.M_runsapprox.C_xz
escherichia_coli.k32	0.000000001	greedytigs	31	na	default	bzip	1	31	1	30	1	1	31	96	96	41	137	96	escherichia_coli.k32.r_0.000000001.S_greedytigs.k_31.d_na.M_default.C_bzip
escherichia_coli.k32	0.000000001	greedytigs	31	na	default	xz	1	31	1	30	1	1	31	96	96	76	172	96	escherichia_coli.k32.r_0.000000001.S_greedytigs.k_31.d_na.M_default.C_xz
escherichia_coli.k32	0.000000001	greedytigs	31	na	ones	bzip	1	31	1	30	1	1	31	96	96	41	137	96	escherichia_coli.k32.r_0.000000001.S_greedytigs.k_31.d_na.M_ones.C_bzip
escherichia_coli.k32	0.000000001	greedytigs	31	na	ones	xz	1	31	1	30	1	1	31	96	96	76	172	96	escherichia_coli.k32.r_0.000000001.S_greedytigs.k_31.d_na.M_ones.C_xz
escherichia_coli.k32	0.000000001	greedytigs	31	na	runsapprox	bzip	1	31	1	30	1	1	31	96	96	41	137	96	escherichia_coli.k32.r_0.000000001.S_greedytigs.k_31.d_na.M_runsapprox.C_bzip
escherichia_coli.k32	0.000000001	greedytigs	31	na	runsapprox	xz	1	31	1	30	1	1	31	96	96	76	172	96	escherichia_coli.k32.r_0.000000001.S_greedytigs.k_31.d_na.M_runsapprox.C_xz
escherichia_coli.k32	0.0001	greedytigs	31	na	default	bzip	16229	503069	16229	486840	16228	16228	503069	142356	135924	49	135973	146512	escherichia_coli.k32.r_0.0001.S_greedytigs.k_31.d_na.M_default.C_bzip
escherichia_coli.k32	0.0001	greedytigs	31	na	default	xz	16229	503069	16229	486840	16228	16228	503069	142356	135924	224	136148	146512	escherichia_coli.k32.r_0.0001.S_greedytigs.k_31.d_na.M_default.C_xz
escherichia_coli.k32	0.0001	greedytigs	31	na	ones	bzip	16229	503069	16229	486840	16228	16228	503069	142356	135924	49	135973	146512	escherichia_coli.k32.r_0.0001.S_greedytigs.k_31.d_na.M_ones.C_bzip
escherichia_coli.k32	0.0001	greedytigs	31	na	ones	xz	16229	503069	16229	486840	16228	16228	503069	142356	135924	224	136148	146512	escherichia_coli.k32.r_0.0001.S_greedytigs.k_31.d_na.M_ones.C_xz
escherichia_coli.k32	0.0001	greedytigs	31	na	runsapprox	bzip	16229	503069	16229	486840	16228	16228	503069	142356	135924	49	135973	146512	escherichia_coli.k32.r_0.0001.S_greedytigs.k_31.d_na.M_runsapprox.C_bzip
escherichia_coli.k32	0.0001	greedytigs	31	na	runsapprox	xz	16229	503069	16229	486840	16228	16228	503069	142356	135924	224	136148	146512	escherichia_coli.k32.r_0.0001.S_greedytigs.k_31.d_na.M_runsapprox.C_xz
escherichia_coli.k32	0.001	greedytigs	31	na	default	bzip	162298	5025568	162298	4863270	162109	162109	5025568	1429288	1310292	521	1310813	1451156	escherichia_coli.k32.r_0.001.S_greedytigs.k_31.d_na.M_default.C_bzip
escherichia_coli.k32	0.001	greedytigs	31	na	default	xz	162298	5025568	162298	4863270	162109	162109	5025568	1429288	1310292	1604	1311896	1451156	escherichia_coli.k32.r_0.001.S_greedytigs.k_31.d_na.M_default.C_xz
escherichia_coli.k32	0.001	greedytigs	31	na	ones	bzip	162298	5025568	162327	4863241	162138	162109	5025568	1429288	1310292	610	1310902	1451308	escherichia_coli.k32.r_0.001.S_greedytigs.k_31.d_na.M_ones.C_bzip
escherichia_coli.k32	0.001	greedytigs	31	na	ones	xz	162298	5025568	162327	4863241	162138	162109	5025568	1429288	1310292	1788	1312080	1451308	escherichia_coli.k32.r_0.001.S_greedytigs.k_31.d_na.M_ones.C_xz
escherichia_coli.k32	0.001	greedytigs	31	na	runsapprox	bzip	162298	5025568	162327	4863241	162138	162109	5025568	1429288	1310292	610	1310902	1451308	escherichia_coli.k32.r_0.001.S_greedytigs.k_31.d_na.M_runsapprox.C_bzip
escherichia_coli.k32	0.001	greedytigs	31	na	runsapprox	xz	162298	5025568	162327	4863241	162138	162109	5025568	1429288	1310292	1788	1312080	1451308	escherichia_coli.k32.r_0.001.S_greedytigs.k_31.d_na.M_runsapprox.C_xz
escherichia_coli.k32	0.01	greedytigs	31	na	default	bzip	1622989	49814809	1622989	48191820	1606394	1606394	49814809	13592668	12468068	28940	12497008	13785812	escherichia_coli.k32.r_0.01.S_greedytigs.k_31.d_na.M_default.C_bzip
escherichia_coli.k32	0.01	greedytigs	31	na	default	xz	1622989	49814809	1622989	48191820	1606394	1606394	49814809	13592668	12468068	54288	12522356	13785812	escherichia_coli.k32.r_0.01.S_greedytigs.k_31.d_na.M_default.C_xz
escherichia_coli.k32	0.01	greedytigs	31	na	ones	bzip	1622989	49814809	1625910	48188899	1609309	1606394	49814809	13592668	12468068	34932	12503000	13788496	escherichia_coli.k32.r_0.01.S_greedytigs.k_31.d_na.M_ones.C_bzip
escherichia_coli.k32	0.01	greedytigs	31	na	ones	xz	1622989	49814809	1625910	48188899	1609309	1606394	49814809	13592668	12468068	69528	12537596	13788496	escherichia_coli.k32.r_0.01.S_greedytigs.k_31.d_na.M_ones.C_xz
escherichia_coli.k32	0.01	greedytigs	31	na	runsapprox	bzip	1622989	49814809	1625910	48188899	1609309	1606394	49814809	13592668	12468068	34932	12503000	13788496	escherichia_coli.k32.r_0.01.S_greedytigs.k_31.d_na.M_runsapprox.C_bzip
escherichia_coli.k32	0.01	greedytigs	31	na	runsapprox	xz	1622989	49814809	1625910	48188899	1609309	1606394	49814809	13592668	12468068	69528	12537596	13788496	escherichia_coli.k32.r_0.01.S_greedytigs.k_31.d_na.M_runsapprox.C_xz
escherichia_coli.k32	0.05	greedytigs	31	na	default	bzip	8114946	239218806	8114946	231103860	7703462	7703462	239218806	62501696	57026188	487340	57513528	63630552	escherichia_coli.k32.r_0.05.S_greedytigs.k_31.d_na.M_default.C_bzip
escherichia_coli.k32	0.05	greedytigs	31	na	default	xz	8114946	239218806	8114946	231103860	7703462	7703462	239218806	62501696	57026188	881020	57907208	63630552	escherichia_coli.k32.r_0.05.S_greedytigs.k_31.d_na.M_default.C_xz
escherichia_coli.k32	0.05	greedytigs	31	na	ones	bzip	8114946	239218806	8184504	231034302	7771863	7703462	239218806	62501696	57026188	600734	57626922	63664856	escherichia_coli.k32.r_0.05.S_greedytigs.k_31.d_na.M_ones.C_bzip
escherichia_coli.k32	0.05	greedytigs	31	na	ones	xz	8114946	239218806	8184504	231034302	7771863	7703462	239218806	62501696	57026188	1159192	58185380	63664856	escherichia_coli.k32.r_0.05.S_greedytigs.k_31.d_na.M_ones.C_xz
escherichia_coli.k32	0.05	greedytigs	31	na	runsapprox	bzip	8114946	239218806	8184504	231034302	7771863	7703462	239218806	62501696	57026188	600734	57626922	63664856	escherichia_coli.k32.r_0.05.S_greedytigs.k_31.d_na.M_runsapprox.C_bzip
escherichia_coli.k32	0.05	greedytigs	31	na	runsapprox	xz	8114946	239218806	8184504	231034302	7771863	7703462	239218806	62501696	57026188	1159192	58185380	63664856	escherichia_coli.k32.r_0.05.S_greedytigs.k_31.d_na.M_runsapprox.C_xz
escherichia_coli.k32	0.1	greedytigs	31	na	default	bzip	16229893	453816618	16229898	437586720	14586224	14586224	453816618	117199832	106856328	1478385	108334713	119784100	escherichia_coli.k32.r_0.1.S_greedytigs.k_31.d_na.M_default.C_bzip
escherichia_coli.k32	0.1	greedytigs	31	na	default	xz	16229893	453816618	16229898	437586720	14586224	14586224	453816618	117199832	106856328	2735428	109591756	119784100	escherichia_coli.k32.r_0.1.S_greedytigs.k_31.d_na.M_default.C_xz
escherichia_coli.k32	0.1	greedytigs	31	na	ones	bzip	16229893	453816618	16493246	437323372	14841281	14586224	453816618	117199832	106856328	1860023	108716351	120012520	escherichia_coli.k32.r_0.1.S_greedytigs.k_31.d_na.M_ones.C_bzip
escherichia_coli.k32	0.1	greedytigs	31	na	ones	xz	16229893	453816618	16493246	437323372	14841281	14586224	453816618	117199832	106856328	3604544	110460872	120012520	escherichia_coli.k32.r_0.1.S_greedytigs.k_31.d_na.M_ones.C_xz
escherichia_coli.k32	0.1	greedytigs	31	na	runsapprox	bzip	16229893	453816618	16493246	437323372	14841281	14586224	453816618	117199832	106856328	1860023	108716351	120012520	escherichia_coli.k32.r_0.1.S_greedytigs.k_31.d_na.M_runsapprox.C_bzip
escherichia_coli.k32	0.1	greedytigs	31	na	runsapprox	xz	16229893	453816618	16493246	437323372	14841281	14586224	453816618	117199832	106856328	3604544	110460872	120012520	escherichia_coli.k32.r_0.1.S_greedytigs.k_31.d_na.M_runsapprox.C_xz
escherichia_coli.k32	0.2	greedytigs	31	na	default	bzip	32459787	809698664	32459954	777238710	25907957	25907957	809698664	208431908	189715088	4156111	193871199	214544296	escherichia_coli.k32.r_0.2.S_greedytigs.k_31.d_na.M_default.C_bzip
escherichia_coli.k32	0.2	greedytigs	31	na	default	xz	32459787	809698664	32459954	777238710	25907957	25907957	809698664	208431908	189715088	7685256	197400344	214544296	escherichia_coli.k32.r_0.2.S_greedytigs.k_31.d_na.M_default.C_xz
escherichia_coli.k32	0.2	greedytigs	31	na	ones	bzip	32459787	809698664	33399995	776298669	26787822	25907957	809698664	208431908	189715088	5350899	195065987	215354652	escherichia_coli.k32.r_0.2.S_greedytigs.k_31.d_na.M_ones.C_bzip
escherichia_coli.k32	0.2	greedytigs	31	na	ones	xz	32459787	809698664	33399995	776298669	26787822	25907957	809698664	208431908	189715088	10113920	199829008	215354652	escherichia_coli.k32.r_0.2.S_greedytigs.k_31.d_na.M_ones.C_xz
escherichia_coli.k32	0.2	greedytigs	31	na	runsapprox	bzip	32459787	809698664	33399995	776298669	26787822	25907957	809698664	208431908	189715088	5350899	195065987	215354652	escherichia_coli.k32.r_0.2.S_greedytigs.k_31.d_na.M_runsapprox.C_bzip
escherichia_coli.k32	0.2	greedytigs	31	na	runsapprox	xz	32459787	809698664	33399995	776298669	26787822	25907957	809698664	208431908	189715088	10113920	199829008	215354652	escherichia_coli.k32.r_0.2.S_greedytigs.k_31.d_na.M_runsapprox.C_xz
escherichia_coli.k32	0.3	greedytigs	31	na	default	bzip	48689681	1068441141	48691221	1019749920	33991664	33991664	1068441141	276442588	251149600	7322723	258472323	286700056	escherichia_coli.k32.r_0.3.S_greedytigs.k_31.d_na.M_default.C_bzip
escherichia_coli.k32	0.3	greedytigs	31	na	default	xz	48689681	1068441141	48691221	1019749920	33991664	33991664	1068441141	276442588	251149600	13348088	264497688	286700056	escherichia_coli.k32.r_0.3.S_greedytigs.k_31.d_na.M_default.C_xz
escherichia_coli.k32	0.3	greedytigs	31	na	ones	bzip	48689681	1068441141	50553774	1017887367	35671663	33991664	1068441141	276442588	251149600	9530244	260679844	288317704	escherichia_coli.k32.r_0.3.S_greedytigs.k_31.d_na.M_ones.C_bzip
escherichia_coli.k32	0.3	greedytigs	31	na	ones	xz	48689681	1068441141	50553774	1017887367	35671663	33991664	1068441141	276442588	251149600	17327708	268477308	288317704	escherichia_coli.k32.r_0.3.S_greedytigs.k_31.d_na.M_ones.C_xz
escherichia_coli.k32	0.3	greedytigs	31	na	runsapprox	bzip	48689681	1068441141	50553774	1017887367	35671663	33991664	1068441141	276442588	251149600	9530244	260679844	288317704	escherichia_coli.k32.r_0.3.S_greedytigs.k_31.d_na.M_runsapprox.C_bzip
escherichia_coli.k32	0.3	greedytigs	31	na	runsapprox	xz	48689681	1068441141	50553774	1017887367	35671663	33991664	1068441141	276442588	251149600	17327708	268477308	288317704	escherichia_coli.k32.r_0.3.S_greedytigs.k_31.d_na.M_runsapprox.C_xz
escherichia_coli.k32	0.4	greedytigs	31	na	default	bzip	64919574	1230789627	64926867	1165862760	38862092	38862092	1230789627	319095188	289544356	10546230	300090586	333228456	escherichia_coli.k32.r_0.4.S_greedytigs.k_31.d_na.M_default.C_bzip
escherichia_coli.k32	0.4	greedytigs	31	na	default	xz	64919574	1230789627	64926867	1165862760	38862092	38862092	1230789627	319095188	289544356	18965188	308509544	333228456	escherichia_coli.k32.r_0.4.S_greedytigs.k_31.d_na.M_default.C_xz
escherichia_coli.k32	0.4	greedytigs	31	na	ones	bzip	64919574	1230789627	67784812	1163004815	41341039	38862092	1230789627	319095188	289544356	13785315	303329671	335678176	escherichia_coli.k32.r_0.4.S_greedytigs.k_31.d_na.M_ones.C_bzip
escherichia_coli.k32	0.4	greedytigs	31	na	ones	xz	64919574	1230789627	67784812	1163004815	41341039	38862092	1230789627	319095188	289544356	24147104	313691460	335678176	escherichia_coli.k32.r_0.4.S_greedytigs.k_31.d_na.M_ones.C_xz
escherichia_coli.k32	0.4	greedytigs	31	na	runsapprox	bzip	64919574	1230789627	67784812	1163004815	41341039	38862092	1230789627	319095188	289544356	13785315	303329671	335678176	escherichia_coli.k32.r_0.4.S_greedytigs.k_31.d_na.M_runsapprox.C_bzip
escherichia_coli.k32	0.4	greedytigs	31	na	runsapprox	xz	64919574	1230789627	67784812	1163004815	41341039	38862092	1230789627	319095188	289544356	24147104	313691460	335678176	escherichia_coli.k32.r_0.4.S_greedytigs.k_31.d_na.M_runsapprox.C_xz
escherichia_coli.k32	0.5	greedytigs	31	na	default	bzip	81149468	1297571055	81176775	1216394280	40546476	40546476	1297571055	337532408	306089752	13421129	319510881	355251768	escherichia_coli.k32.r_0.5.S_greedytigs.k_31.d_na.M_default.C_bzip
escherichia_coli.k32	0.5	greedytigs	31	na	default	xz	81149468	1297571055	81176775	1216394280	40546476	40546476	1297571055	337532408	306089752	23828260	329918012	355251768	escherichia_coli.k32.r_0.5.S_greedytigs.k_31.d_na.M_default.C_xz
escherichia_coli.k32	0.5	greedytigs	31	na	ones	bzip	81149468	1297571055	84939605	1212631450	43668712	40546476	1297571055	337532408	306089752	17536594	323626346	358412228	escherichia_coli.k32.r_0.5.S_greedytigs.k_31.d_na.M_ones.C_bzip
escherichia_coli.k32	0.5	greedytigs	31	na	ones	xz	81149468	1297571055	84939605	1212631450	43668712	40546476	1297571055	337532408	306089752	29641740	335731492	358412228	escherichia_coli.k32.r_0.5.S_greedytigs.k_31.d_na.M_ones.C_xz
escherichia_coli.k32	0.5	greedytigs	31	na	runsapprox	bzip	81149468	1297571055	84939605	1212631450	43668712	40546476	1297571055	337532408	306089752	17536594	323626346	358412228	escherichia_coli.k32.r_0.5.S_greedytigs.k_31.d_na.M_runsapprox.C_bzip
escherichia_coli.k32	0.5	greedytigs	31	na	runsapprox	xz	81149468	1297571055	84939605	1212631450	43668712	40546476	1297571055	337532408	306089752	29641740	335731492	358412228	escherichia_coli.k32.r_0.5.S_greedytigs.k_31.d_na.M_runsapprox.C_xz
escherichia_coli.k32	0.6	greedytigs	31	na	default	bzip	97379362	1269308330	97467320	1171841010	39061367	39061367	1269308330	332022856	301036784	15495213	316531997	352535192	escherichia_coli.k32.r_0.6.S_greedytigs.k_31.d_na.M_default.C_bzip
escherichia_coli.k32	0.6	greedytigs	31	na	default	xz	97379362	1269308330	97467320	1171841010	39061367	39061367	1269308330	332022856	301036784	27080152	328116936	352535192	escherichia_coli.k32.r_0.6.S_greedytigs.k_31.d_na.M_default.C_xz
escherichia_coli.k32	0.6	greedytigs	31	na	ones	bzip	97379362	1269308330	101882980	1167425350	42541167	39061367	1269308330	332022856	301036784	20163200	321199984	356192976	escherichia_coli.k32.r_0.6.S_greedytigs.k_31.d_na.M_ones.C_bzip
escherichia_coli.k32	0.6	greedytigs	31	na	ones	xz	97379362	1269308330	101882980	1167425350	42541167	39061367	1269308330	332022856	301036784	32911592	333948376	356192976	escherichia_coli.k32.r_0.6.S_greedytigs.k_31.d_na.M_ones.C_xz
escherichia_coli.k32	0.6	greedytigs	31	na	runsapprox	bzip	97379362	1269308330	101882980	1167425350	42541167	39061367	1269308330	332022856	301036784	20163200	321199984	356192976	escherichia_coli.k32.r_0.6.S_greedytigs.k_31.d_na.M_runsapprox.C_bzip
escherichia_coli.k32	0.6	greedytigs	31	na	runsapprox	xz	97379362	1269308330	101882980	1167425350	42541167	39061367	1269308330	332022856	301036784	32911592	333948376	356192976	escherichia_coli.k32.r_0.6.S_greedytigs.k_31.d_na.M_runsapprox.C_xz
escherichia_coli.k32	0.7	greedytigs	31	na	default	bzip	113609255	1146442809	113877579	1032565230	34418841	34418841	1146442809	301007236	273247548	16114134	289361682	323525308	escherichia_coli.k32.r_0.7.S_greedytigs.k_31.d_na.M_default.C_bzip
escherichia_coli.k32	0.7	greedytigs	31	na	default	xz	113609255	1146442809	113877579	1032565230	34418841	34418841	1146442809	301007236	273247548	27757064	301004612	323525308	escherichia_coli.k32.r_0.7.S_greedytigs.k_31.d_na.M_default.C_xz
escherichia_coli.k32	0.7	greedytigs	31	na	ones	bzip	113609255	1146442809	118510019	1027932790	37848422	34418841	1146442809	301007236	273247548	20860188	294107736	327289332	escherichia_coli.k32.r_0.7.S_greedytigs.k_31.d_na.M_ones.C_bzip
escherichia_coli.k32	0.7	greedytigs	31	na	ones	xz	113609255	1146442809	118510019	1027932790	37848422	34418841	1146442809	301007236	273247548	33057816	306305364	327289332	escherichia_coli.k32.r_0.7.S_greedytigs.k_31.d_na.M_ones.C_xz
escherichia_coli.k32	0.7	greedytigs	31	na	runsapprox	bzip	113609255	1146442809	118510019	1027932790	37848422	34418841	1146442809	301007236	273247548	20860188	294107736	327289332	escherichia_coli.k32.r_0.7.S_greedytigs.k_31.d_na.M_runsapprox.C_bzip
escherichia_coli.k32	0.7	greedytigs	31	na	runsapprox	xz	113609255	1146442809	118510019	1027932790	37848422	34418841	1146442809	301007236	273247548	33057816	306305364	327289332	escherichia_coli.k32.r_0.7.S_greedytigs.k_31.d_na.M_runsapprox.C_xz
escherichia_coli.k32	0.8	greedytigs	31	na	default	bzip	129839149	928543382	130681772	797861610	26595387	26595387	928543382	244834748	222683920	14656694	237340614	267655728	escherichia_coli.k32.r_0.8.S_greedytigs.k_31.d_na.M_default.C_bzip
escherichia_coli.k32	0.8	greedytigs	31	na	default	xz	129839149	928543382	130681772	797861610	26595387	26595387	928543382	244834748	222683920	24860412	247544332	267655728	escherichia_coli.k32.r_0.8.S_greedytigs.k_31.d_na.M_default.C_xz
escherichia_coli.k32	0.8	greedytigs	31	na	ones	bzip	129839149	928543382	134930204	793613178	29482237	26595387	928543382	244834748	222683920	18845988	241529908	271089424	escherichia_coli.k32.r_0.8.S_greedytigs.k_31.d_na.M_ones.C_bzip
escherichia_coli.k32	0.8	greedytigs	31	na	ones	xz	129839149	928543382	134930204	793613178	29482237	26595387	928543382	244834748	222683920	29141840	251825760	271089424	escherichia_coli.k32.r_0.8.S_greedytigs.k_31.d_na.M_ones.C_xz
escherichia_coli.k32	0.8	greedytigs	31	na	runsapprox	bzip	129839149	928543382	134930204	793613178	29482237	26595387	928543382	244834748	222683920	18845988	241529908	271089424	escherichia_coli.k32.r_0.8.S_greedytigs.k_31.d_na.M_runsapprox.C_bzip
escherichia_coli.k32	0.8	greedytigs	31	na	runsapprox	xz	129839149	928543382	134930204	793613178	29482237	26595387	928543382	244834748	222683920	29141840	251825760	271089424	escherichia_coli.k32.r_0.8.S_greedytigs.k_31.d_na.M_runsapprox.C_xz
escherichia_coli.k32	0.9	greedytigs	31	na	default	bzip	146069043	614821342	149308822	465512520	15517084	15517084	614821342	160120968	146448804	10369373	156818177	179624268	escherichia_coli.k32.r_0.9.S_greedytigs.k_31.d_na.M_default.C_bzip
escherichia_coli.k32	0.9	greedytigs	31	na	default	xz	146069043	614821342	149308822	465512520	15517084	15517084	614821342	160120968	146448804	17121960	163570764	179624268	escherichia_coli.k32.r_0.9.S_greedytigs.k_31.d_na.M_default.C_xz
escherichia_coli.k32	0.9	greedytigs	31	na	ones	bzip	146069043	614821342	152335625	462485717	17281106	15517084	614821342	160120968	146448804	13197605	159646409	181891684	escherichia_coli.k32.r_0.9.S_greedytigs.k_31.d_na.M_ones.C_bzip
escherichia_coli.k32	0.9	greedytigs	31	na	ones	xz	146069043	614821342	152335625	462485717	17281106	15517084	614821342	160120968	146448804	19966436	166415240	181891684	escherichia_coli.k32.r_0.9.S_greedytigs.k_31.d_na.M_ones.C_xz
escherichia_coli.k32	0.9	greedytigs	31	na	runsapprox	bzip	146069043	614821342	152335625	462485717	17281106	15517084	614821342	160120968	146448804	13197605	159646409	181891684	escherichia_coli.k32.r_0.9.S_greedytigs.k_31.d_na.M_runsapprox.C_bzip
escherichia_coli.k32	0.9	greedytigs	31	na	runsapprox	xz	146069043	614821342	152335625	462485717	17281106	15517084	614821342	160120968	146448804	19966436	166415240	181891684	escherichia_coli.k32.r_0.9.S_greedytigs.k_31.d_na.M_runsapprox.C_xz
escherichia_coli.k32	1.0	greedytigs	31	na	default	bzip	162298937	202444634	180314924	22129710	737657	737657	202444634	39439948	38595480	865767	39461247	42947524	escherichia_coli.k32.r_1.0.S_greedytigs.k_31.d_na.M_default.C_bzip
escherichia_coli.k32	1.0	greedytigs	31	na	default	xz	162298937	202444634	180314924	22129710	737657	737657	202444634	39439948	38595480	1891304	40486784	42947524	escherichia_coli.k32.r_1.0.S_greedytigs.k_31.d_na.M_default.C_xz
escherichia_coli.k32	1.0	greedytigs	31	na	ones	bzip	162298937	202444634	180805092	21639542	738894	737657	202444634	39439948	38595480	1043735	39639215	42948540	escherichia_coli.k32.r_1.0.S_greedytigs.k_31.d_na.M_ones.C_bzip
escherichia_coli.k32	1.0	greedytigs	31	na	ones	xz	162298937	202444634	180805092	21639542	738894	737657	202444634	39439948	38595480	2113260	40708740	42948540	escherichia_coli.k32.r_1.0.S_greedytigs.k_31.d_na.M_ones.C_xz
escherichia_coli.k32	1.0	greedytigs	31	na	runsapprox	bzip	162298937	202444634	180803311	21641323	737651	737657	202444634	39439948	38595480	1040565	39636045	42948112	escherichia_coli.k32.r_1.0.S_greedytigs.k_31.d_na.M_runsapprox.C_bzip
escherichia_coli.k32	1.0	greedytigs	31	na	runsapprox	xz	162298937	202444634	180803311	21641323	737651	737657	202444634	39439948	38595480	2110172	40705652	42948112	escherichia_coli.k32.r_1.0.S_greedytigs.k_31.d_na.M_runsapprox.C_xz
escherichia_coli.k32	0.000000001	matchtigs	31	na	default	bzip	1	31	1	30	1	1	31	96	96	41	137	96	escherichia_coli.k32.r_0.000000001.S_matchtigs.k_31.d_na.M_default.C_bzip
escherichia_coli.k32	0.000000001	matchtigs	31	na	default	xz	1	31	1	30	1	1	31	96	96	76	172	96	escherichia_coli.k32.r_0.000000001.S_matchtigs.k_31.d_na.M_default.C_xz
escherichia_coli.k32	0.000000001	matchtigs	31	na	ones	bzip	1	31	1	30	1	1	31	96	96	41	137	96	escherichia_coli.k32.r_0.000000001.S_matchtigs.k_31.d_na.M_ones.C_bzip
escherichia_coli.k32	0.000000001	matchtigs	31	na	ones	xz	1	31	1	30	1	1	31	96	96	76	172	96	escherichia_coli.k32.r_0.000000001.S_matchtigs.k_31.d_na.M_ones.C_xz
escherichia_coli.k32	0.000000001	matchtigs	31	na	runsapprox	bzip	1	31	1	30	1	1	31	96	96	41	137	96	escherichia_coli.k32.r_0.000000001.S_matchtigs.k_31.d_na.M_runsapprox.C_bzip
escherichia_coli.k32	0.000000001	matchtigs	31	na	runsapprox	xz	1	31	1	30	1	1	31	96	96	76	172	96	escherichia_coli.k32.r_0.000000001.S_matchtigs.k_31.d_na.M_runsapprox.C_xz
escherichia_coli.k32	0.0001	matchtigs	31	na	default	bzip	16229	503069	16229	486840	16228	16228	503069	142356	135924	49	135973	146512	escherichia_coli.k32.r_0.0001.S_matchtigs.k_31.d_na.M_default.C_bzip
escherichia_coli.k32	0.0001	matchtigs	31	na	default	xz	16229	503069	16229	486840	16228	16228	503069	142356	135924	224	136148	146512	escherichia_coli.k32.r_0.0001.S_matchtigs.k_31.d_na.M_default.C_xz
escherichia_coli.k32	0.0001	matchtigs	31	na	ones	bzip	16229	503069	16229	486840	16228	16228	503069	142356	135924	49	135973	146512	escherichia_coli.k32.r_0.0001.S_matchtigs.k_31.d_na.M_ones.C_bzip
escherichia_coli.k32	0.0001	matchtigs	31	na	ones	xz	16229	503069	16229	486840	16228	16228	503069	142356	135924	224	136148	146512	escherichia_coli.k32.r_0.0001.S_matchtigs.k_31.d_na.M_ones.C_xz
escherichia_coli.k32	0.0001	matchtigs	31	na	runsapprox	bzip	16229	503069	16229	486840	16228	16228	503069	142356	135924	49	135973	146512	escherichia_coli.k32.r_0.0001.S_matchtigs.k_31.d_na.M_runsapprox.C_bzip
escherichia_coli.k32	0.0001	matchtigs	31	na	runsapprox	xz	16229	503069	16229	486840	16228	16228	503069	142356	135924	224	136148	146512	escherichia_coli.k32.r_0.0001.S_matchtigs.k_31.d_na.M_runsapprox.C_xz
escherichia_coli.k32	0.001	matchtigs	31	na	default	bzip	162298	5025568	162298	4863270	162109	162109	5025568	1429288	1310292	521	1310813	1451156	escherichia_coli.k32.r_0.001.S_matchtigs.k_31.d_na.M_default.C_bzip
escherichia_coli.k32	0.001	matchtigs	31	na	default	xz	162298	5025568	162298	4863270	162109	162109	5025568	1429288	1310292	1604	1311896	1451156	escherichia_coli.k32.r_0.001.S_matchtigs.k_31.d_na.M_default.C_xz
escherichia_coli.k32	0.001	matchtigs	31	na	ones	bzip	162298	5025568	162327	4863241	162138	162109	5025568	1429288	1310292	610	1310902	1451308	escherichia_coli.k32.r_0.001.S_matchtigs.k_31.d_na.M_ones.C_bzip
escherichia_coli.k32	0.001	matchtigs	31	na	ones	xz	162298	5025568	162327	4863241	162138	162109	5025568	1429288	1310292	1788	1312080	1451308	escherichia_coli.k32.r_0.001.S_matchtigs.k_31.d_na.M_ones.C_xz
escherichia_coli.k32	0.001	matchtigs	31	na	runsapprox	bzip	162298	5025568	162327	4863241	162138	162109	5025568	1429288	1310292	610	1310902	1451308	escherichia_coli.k32.r_0.001.S_matchtigs.k_31.d_na.M_runsapprox.C_bzip
escherichia_coli.k32	0.001	matchtigs	31	na	runsapprox	xz	162298	5025568	162327	4863241	162138	162109	5025568	1429288	1310292	1788	1312080	1451308	escherichia_coli.k32.r_0.001.S_matchtigs.k_31.d_na.M_runsapprox.C_xz
escherichia_coli.k32	0.01	matchtigs	31	na	default	bzip	1622989	49814809	1622989	48191820	1606394	1606394	49814809	13592668	12468068	28940	12497008	13785812	escherichia_coli.k32.r_0.01.S_matchtigs.k_31.d_na.M_default.C_bzip
escherichia_coli.k32	0.01	matchtigs	31	na	default	xz	1622989	49814809	1622989	48191820	1606394	1606394	49814809	13592668	12468068	54288	12522356	13785812	escherichia_coli.k32.r_0.01.S_matchtigs.k_31.d_na.M_default.C_xz
escherichia_coli.k32	0.01	matchtigs	31	na	ones	bzip	1622989	49814809	1625910	48188899	1609309	1606394	49814809	13592668	12468068	34932	12503000	13788496	escherichia_coli.k32.r_0.01.S_matchtigs.k_31.d_na.M_ones.C_bzip
escherichia_coli.k32	0.01	matchtigs	31	na	ones	xz	1622989	49814809	1625910	48188899	1609309	1606394	49814809	13592668	12468068	69528	12537596	13788496	escherichia_coli.k32.r_0.01.S_matchtigs.k_31.d_na.M_ones.C_xz
escherichia_coli.k32	0.01	matchtigs	31	na	runsapprox	bzip	1622989	49814809	1625910	48188899	1609309	1606394	49814809	13592668	12468068	34932	12503000	13788496	escherichia_coli.k32.r_0.01.S_matchtigs.k_31.d_na.M_runsapprox.C_bzip
escherichia_coli.k32	0.01	matchtigs	31	na	runsapprox	xz	1622989	49814809	1625910	48188899	1609309	1606394	49814809	13592668	12468068	69528	12537596	13788496	escherichia_coli.k32.r_0.01.S_matchtigs.k_31.d_na.M_runsapprox.C_xz
escherichia_coli.k32	0.05	matchtigs	31	na	default	bzip	8114946	239218806	8114946	231103860	7703462	7703462	239218806	62501696	57026188	487340	57513528	63630552	escherichia_coli.k32.r_0.05.S_matchtigs.k_31.d_na.M_default.C_bzip
escherichia_coli.k32	0.05	matchtigs	31	na	default	xz	8114946	239218806	8114946	231103860	7703462	7703462	239218806	62501696	57026188	881020	57907208	63630552	escherichia_coli.k32.r_0.05.S_matchtigs.k_31.d_na.M_default.C_xz
escherichia_coli.k32	0.05	matchtigs	31	na	ones	bzip	8114946	239218806	8184504	231034302	7771863	7703462	239218806	62501696	57026188	600734	57626922	63664856	escherichia_coli.k32.r_0.05.S_matchtigs.k_31.d_na.M_ones.C_bzip
escherichia_coli.k32	0.05	matchtigs	31	na	ones	xz	8114946	239218806	8184504	231034302	7771863	7703462	239218806	62501696	57026188	1159192	58185380	63664856	escherichia_coli.k32.r_0.05.S_matchtigs.k_31.d_na.M_ones.C_xz
escherichia_coli.k32	0.05	matchtigs	31	na	runsapprox	bzip	8114946	239218806	8184504	231034302	7771863	7703462	239218806	62501696	57026188	600734	57626922	63664856	escherichia_coli.k32.r_0.05.S_matchtigs.k_31.d_na.M_runsapprox.C_bzip
escherichia_coli.k32	0.05	matchtigs	31	na	runsapprox	xz	8114946	239218806	8184504	231034302	7771863	7703462	239218806	62501696	57026188	1159192	58185380	63664856	escherichia_coli.k32.r_0.05.S_matchtigs.k_31.d_na.M_runsapprox.C_xz
escherichia_coli.k32	0.1	matchtigs	31	na	default	bzip	16229893	453816733	16229893	437586840	14586228	14586228	453816733	117130096	106791392	1478198	108269590	119718092	escherichia_coli.k32.r_0.1.S_matchtigs.k_31.d_na.M_default.C_bzip
escherichia_coli.k32	0.1	matchtigs	31	na	default	xz	16229893	453816733	16229893	437586840	14586228	14586228	453816733	117130096	106791392	2734372	109525764	119718092	escherichia_coli.k32.r_0.1.S_matchtigs.k_31.d_na.M_default.C_xz
escherichia_coli.k32	0.1	matchtigs	31	na	ones	bzip	16229893	453816733	16492890	437323843	14840824	14586228	453816733	117130096	106791392	1858808	108650200	119952024	escherichia_coli.k32.r_0.1.S_matchtigs.k_31.d_na.M_ones.C_bzip
escherichia_coli.k32	0.1	matchtigs	31	na	ones	xz	16229893	453816733	16492890	437323843	14840824	14586228	453816733	117130096	106791392	3603536	110394928	119952024	escherichia_coli.k32.r_0.1.S_matchtigs.k_31.d_na.M_ones.C_xz
escherichia_coli.k32	0.1	matchtigs	31	na	runsapprox	bzip	16229893	453816733	16492890	437323843	14840824	14586228	453816733	117130096	106791392	1858808	108650200	119952024	escherichia_coli.k32.r_0.1.S_matchtigs.k_31.d_na.M_runsapprox.C_bzip
escherichia_coli.k32	0.1	matchtigs	31	na	runsapprox	xz	16229893	453816733	16492890	437323843	14840824	14586228	453816733	117130096	106791392	3603536	110394928	119952024	escherichia_coli.k32.r_0.1.S_matchtigs.k_31.d_na.M_runsapprox.C_xz
escherichia_coli.k32	0.2	matchtigs	31	na	default	bzip	32459787	809702221	32459791	777242430	25908081	25908081	809702221	208445476	189719680	4156542	193876222	214525564	escherichia_coli.k32.r_0.2.S_matchtigs.k_31.d_na.M_default.C_bzip
escherichia_coli.k32	0.2	matchtigs	31	na	default	xz	32459787	809702221	32459791	777242430	25908081	25908081	809702221	208445476	189719680	7684892	197404572	214525564	escherichia_coli.k32.r_0.2.S_matchtigs.k_31.d_na.M_default.C_xz
escherichia_coli.k32	0.2	matchtigs	31	na	ones	bzip	32459787	809702221	33399822	776302399	26788092	25908081	809702221	208445476	189719680	5350425	195070105	215367128	escherichia_coli.k32.r_0.2.S_matchtigs.k_31.d_na.M_ones.C_bzip
escherichia_coli.k32	0.2	matchtigs	31	na	ones	xz	32459787	809702221	33399822	776302399	26788092	25908081	809702221	208445476	189719680	10111648	199831328	215367128	escherichia_coli.k32.r_0.2.S_matchtigs.k_31.d_na.M_ones.C_xz
escherichia_coli.k32	0.2	matchtigs	31	na	runsapprox	bzip	32459787	809702221	33399822	776302399	26788092	25908081	809702221	208445476	189719680	5350425	195070105	215367128	escherichia_coli.k32.r_0.2.S_matchtigs.k_31.d_na.M_runsapprox.C_bzip
escherichia_coli.k32	0.2	matchtigs	31	na	runsapprox	xz	32459787	809702221	33399822	776302399	26788092	25908081	809702221	208445476	189719680	10111648	199831328	215367128	escherichia_coli.k32.r_0.2.S_matchtigs.k_31.d_na.M_runsapprox.C_xz
escherichia_coli.k32	1.0	matchtigs	31	na	default	bzip	162298937	198507645	173924205	24583440	819448	819448	198507645	39911876	39010040	935202	39945242	43584344	escherichia_coli.k32.r_1.0.S_matchtigs.k_31.d_na.M_default.C_bzip
escherichia_coli.k32	1.0	matchtigs	31	na	default	xz	162298937	198507645	173924205	24583440	819448	819448	198507645	39911876	39010040	2005696	41015736	43584344	escherichia_coli.k32.r_1.0.S_matchtigs.k_31.d_na.M_default.C_xz
escherichia_coli.k32	1.0	matchtigs	31	na	ones	bzip	162298937	198507645	174467344	24040301	820827	819448	198507645	39911876	39010040	1134249	40144289	43589952	escherichia_coli.k32.r_1.0.S_matchtigs.k_31.d_na.M_ones.C_bzip
escherichia_coli.k32	1.0	matchtigs	31	na	ones	xz	162298937	198507645	174467344	24040301	820827	819448	198507645	39911876	39010040	2252800	41262840	43589952	escherichia_coli.k32.r_1.0.S_matchtigs.k_31.d_na.M_ones.C_xz
escherichia_coli.k32	1.0	matchtigs	31	na	runsapprox	bzip	162298937	198507645	174467344	24040301	820827	819448	198507645	39911876	39010040	1134249	40144289	43589952	escherichia_coli.k32.r_1.0.S_matchtigs.k_31.d_na.M_runsapprox.C_bzip
escherichia_coli.k32	1.0	matchtigs	31	na	runsapprox	xz	162298937	198507645	174467344	24040301	820827	819448	198507645	39911876	39010040	2252800	41262840	43589952	escherichia_coli.k32.r_1.0.S_matchtigs.k_31.d_na.M_runsapprox.C_xz
escherichia_coli.k32	0.000000001	prophasm	31	na	default	bzip	1	31	1	30	1	1	31	96	96	41	137	96	escherichia_coli.k32.r_0.000000001.S_prophasm.k_31.d_na.M_default.C_bzip
escherichia_coli.k32	0.000000001	prophasm	31	na	default	xz	1	31	1	30	1	1	31	96	96	76	172	96	escherichia_coli.k32.r_0.000000001.S_prophasm.k_31.d_na.M_default.C_xz
escherichia_coli.k32	0.000000001	prophasm	31	na	ones	bzip	1	31	1	30	1	1	31	96	96	41	137	96	escherichia_coli.k32.r_0.000000001.S_prophasm.k_31.d_na.M_ones.C_bzip
escherichia_coli.k32	0.000000001	prophasm	31	na	ones	xz	1	31	1	30	1	1	31	96	96	76	172	96	escherichia_coli.k32.r_0.000000001.S_prophasm.k_31.d_na.M_ones.C_xz
escherichia_coli.k32	0.000000001	prophasm	31	na	runsapprox	bzip	1	31	1	30	1	1	31	96	96	41	137	96	escherichia_coli.k32.r_0.000000001.S_prophasm.k_31.d_na.M_runsapprox.C_bzip
escherichia_coli.k32	0.000000001	prophasm	31	na	runsapprox	xz	1	31	1	30	1	1	31	96	96	76	172	96	escherichia_coli.k32.r_0.000000001.S_prophasm.k_31.d_na.M_runsapprox.C_xz
escherichia_coli.k32	0.0001	prophasm	31	na	default	bzip	16229	503069	16229	486840	16228	16228	503069	145236	136484	49	136533	150144	escherichia_coli.k32.r_0.0001.S_prophasm.k_31.d_na.M_default.C_bzip
escherichia_coli.k32	0.0001	prophasm	31	na	default	xz	16229	503069	16229	486840	16228	16228	503069	145236	136484	224	136708	150144	escherichia_coli.k32.r_0.0001.S_prophasm.k_31.d_na.M_default.C_xz
escherichia_coli.k32	0.0001	prophasm	31	na	ones	bzip	16229	503069	16229	486840	16228	16228	503069	145236	136484	49	136533	150144	escherichia_coli.k32.r_0.0001.S_prophasm.k_31.d_na.M_ones.C_bzip
escherichia_coli.k32	0.0001	prophasm	31	na	ones	xz	16229	503069	16229	486840	16228	16228	503069	145236	136484	224	136708	150144	escherichia_coli.k32.r_0.0001.S_prophasm.k_31.d_na.M_ones.C_xz
escherichia_coli.k32	0.0001	prophasm	31	na	runsapprox	bzip	16229	503069	16229	486840	16228	16228	503069	145236	136484	49	136533	150144	escherichia_coli.k32.r_0.0001.S_prophasm.k_31.d_na.M_runsapprox.C_bzip
escherichia_coli.k32	0.0001	prophasm	31	na	runsapprox	xz	16229	503069	16229	486840	16228	16228	503069	145236	136484	224	136708	150144	escherichia_coli.k32.r_0.0001.S_prophasm.k_31.d_na.M_runsapprox.C_xz
escherichia_coli.k32	0.001	prophasm	31	na	default	bzip	162298	5025568	162298	4863270	162109	162109	5025568	1437140	1321168	517	1321685	1457444	escherichia_coli.k32.r_0.001.S_prophasm.k_31.d_na.M_default.C_bzip
escherichia_coli.k32	0.001	prophasm	31	na	default	xz	162298	5025568	162298	4863270	162109	162109	5025568	1437140	1321168	1544	1322712	1457444	escherichia_coli.k32.r_0.001.S_prophasm.k_31.d_na.M_default.C_xz
escherichia_coli.k32	0.001	prophasm	31	na	ones	bzip	162298	5025568	162319	4863249	162130	162109	5025568	1437140	1321168	581	1321749	1457620	escherichia_coli.k32.r_0.001.S_prophasm.k_31.d_na.M_ones.C_bzip
escherichia_coli.k32	0.001	prophasm	31	na	ones	xz	162298	5025568	162319	4863249	162130	162109	5025568	1437140	1321168	1708	1322876	1457620	escherichia_coli.k32.r_0.001.S_prophasm.k_31.d_na.M_ones.C_xz
escherichia_coli.k32	0.001	prophasm	31	na	runsapprox	bzip	162298	5025568	162319	4863249	162130	162109	5025568	1437140	1321168	581	1321749	1457620	escherichia_coli.k32.r_0.001.S_prophasm.k_31.d_na.M_runsapprox.C_bzip
escherichia_coli.k32	0.001	prophasm	31	na	runsapprox	xz	162298	5025568	162319	4863249	162130	162109	5025568	1437140	1321168	1708	1322876	1457620	escherichia_coli.k32.r_0.001.S_prophasm.k_31.d_na.M_runsapprox.C_xz
escherichia_coli.k32	0.01	prophasm	31	na	default	bzip	1622989	49814809	1622989	48191820	1606394	1606394	49814809	13865512	12691576	28004	12719580	14055492	escherichia_coli.k32.r_0.01.S_prophasm.k_31.d_na.M_default.C_bzip
escherichia_coli.k32	0.01	prophasm	31	na	default	xz	1622989	49814809	1622989	48191820	1606394	1606394	49814809	13865512	12691576	53068	12744644	14055492	escherichia_coli.k32.r_0.01.S_prophasm.k_31.d_na.M_default.C_xz
escherichia_coli.k32	0.01	prophasm	31	na	ones	bzip	1622989	49814809	1625913	48188896	1609314	1606394	49814809	13865512	12691576	34187	12725763	14058000	escherichia_coli.k32.r_0.01.S_prophasm.k_31.d_na.M_ones.C_bzip
escherichia_coli.k32	0.01	prophasm	31	na	ones	xz	1622989	49814809	1625913	48188896	1609314	1606394	49814809	13865512	12691576	68244	12759820	14058000	escherichia_coli.k32.r_0.01.S_prophasm.k_31.d_na.M_ones.C_xz
escherichia_coli.k32	0.01	prophasm	31	na	runsapprox	bzip	1622989	49814809	1625913	48188896	1609314	1606394	49814809	13865512	12691576	34187	12725763	14058000	escherichia_coli.k32.r_0.01.S_prophasm.k_31.d_na.M_runsapprox.C_bzip
escherichia_coli.k32	0.01	prophasm	31	na	runsapprox	xz	1622989	49814809	1625913	48188896	1609314	1606394	49814809	13865512	12691576	68244	12759820	14058000	escherichia_coli.k32.r_0.01.S_prophasm.k_31.d_na.M_runsapprox.C_xz
escherichia_coli.k32	0.05	prophasm	31	na	default	bzip	8114946	239218806	8114946	231103860	7703462	7703462	239218806	65338412	59644900	456529	60101429	66470704	escherichia_coli.k32.r_0.05.S_prophasm.k_31.d_na.M_default.C_bzip
escherichia_coli.k32	0.05	prophasm	31	na	default	xz	8114946	239218806	8114946	231103860	7703462	7703462	239218806	65338412	59644900	834204	60479104	66470704	escherichia_coli.k32.r_0.05.S_prophasm.k_31.d_na.M_default.C_xz
escherichia_coli.k32	0.05	prophasm	31	na	ones	bzip	8114946	239218806	8185874	231032932	7773266	7703462	239218806	65338412	59644900	573797	60218697	66550000	escherichia_coli.k32.r_0.05.S_prophasm.k_31.d_na.M_ones.C_bzip
escherichia_coli.k32	0.05	prophasm	31	na	ones	xz	8114946	239218806	8185874	231032932	7773266	7703462	239218806	65338412	59644900	1118028	60762928	66550000	escherichia_coli.k32.r_0.05.S_prophasm.k_31.d_na.M_ones.C_xz
escherichia_coli.k32	0.05	prophasm	31	na	runsapprox	bzip	8114946	239218806	8185874	231032932	7773266	7703462	239218806	65338412	59644900	573797	60218697	66550000	escherichia_coli.k32.r_0.05.S_prophasm.k_31.d_na.M_runsapprox.C_bzip
escherichia_coli.k32	0.05	prophasm	31	na	runsapprox	xz	8114946	239218806	8185874	231032932	7773266	7703462	239218806	65338412	59644900	1118028	60762928	66550000	escherichia_coli.k32.r_0.05.S_prophasm.k_31.d_na.M_runsapprox.C_xz
escherichia_coli.k32	0.1	prophasm	31	na	default	bzip	16229893	453816733	16229893	437586840	14586228	14586228	453816733	123743784	112899096	1375225	114274321	126372116	escherichia_coli.k32.r_0.1.S_prophasm.k_31.d_na.M_default.C_bzip
escherichia_coli.k32	0.1	prophasm	31	na	default	xz	16229893	453816733	16229893	437586840	14586228	14586228	453816733	123743784	112899096	2535184	115434280	126372116	escherichia_coli.k32.r_0.1.S_prophasm.k_31.d_na.M_default.C_xz
escherichia_coli.k32	0.1	prophasm	31	na	ones	bzip	16229893	453816733	16500531	437316202	14848433	14586228	453816733	123743784	112899096	1769142	114668238	126659392	escherichia_coli.k32.r_0.1.S_prophasm.k_31.d_na.M_ones.C_bzip
escherichia_coli.k32	0.1	prophasm	31	na	ones	xz	16229893	453816733	16500531	437316202	14848433	14586228	453816733	123743784	112899096	3443800	116342896	126659392	escherichia_coli.k32.r_0.1.S_prophasm.k_31.d_na.M_ones.C_xz
escherichia_coli.k32	0.1	prophasm	31	na	runsapprox	bzip	16229893	453816733	16500531	437316202	14848433	14586228	453816733	123743784	112899096	1769142	114668238	126659392	escherichia_coli.k32.r_0.1.S_prophasm.k_31.d_na.M_runsapprox.C_bzip
escherichia_coli.k32	0.1	prophasm	31	na	runsapprox	xz	16229893	453816733	16500531	437316202	14848433	14586228	453816733	123743784	112899096	3443800	116342896	126659392	escherichia_coli.k32.r_0.1.S_prophasm.k_31.d_na.M_runsapprox.C_xz
escherichia_coli.k32	0.2	prophasm	31	na	default	bzip	32459787	809702277	32459787	777242490	25908083	25908083	809702277	220704908	200816088	3861345	204677433	226478100	escherichia_coli.k32.r_0.2.S_prophasm.k_31.d_na.M_default.C_bzip
escherichia_coli.k32	0.2	prophasm	31	na	default	xz	32459787	809702277	32459787	777242490	25908083	25908083	809702277	220704908	200816088	7089292	207905380	226478100	escherichia_coli.k32.r_0.2.S_prophasm.k_31.d_na.M_default.C_xz
escherichia_coli.k32	0.2	prophasm	31	na	ones	bzip	32459787	809702277	33420052	776282225	26807291	25908083	809702277	220704908	200816088	5096784	205912872	227414484	escherichia_coli.k32.r_0.2.S_prophasm.k_31.d_na.M_ones.C_bzip
escherichia_coli.k32	0.2	prophasm	31	na	ones	xz	32459787	809702277	33420052	776282225	26807291	25908083	809702277	220704908	200816088	9650048	210466136	227414484	escherichia_coli.k32.r_0.2.S_prophasm.k_31.d_na.M_ones.C_xz
escherichia_coli.k32	0.2	prophasm	31	na	runsapprox	bzip	32459787	809702277	33420052	776282225	26807291	25908083	809702277	220704908	200816088	5096784	205912872	227414484	escherichia_coli.k32.r_0.2.S_prophasm.k_31.d_na.M_runsapprox.C_bzip
escherichia_coli.k32	0.2	prophasm	31	na	runsapprox	xz	32459787	809702277	33420052	776282225	26807291	25908083	809702277	220704908	200816088	9650048	210466136	227414484	escherichia_coli.k32.r_0.2.S_prophasm.k_31.d_na.M_runsapprox.C_xz
escherichia_coli.k32	0.3	prophasm	31	na	default	bzip	48689681	1068469661	48689681	1019779980	33992666	33992666	1068469661	291239008	265146900	6780974	271927874	300908632	escherichia_coli.k32.r_0.3.S_prophasm.k_31.d_na.M_default.C_bzip
escherichia_coli.k32	0.3	prophasm	31	na	default	xz	48689681	1068469661	48689681	1019779980	33992666	33992666	1068469661	291239008	265146900	12282028	277428928	300908632	escherichia_coli.k32.r_0.3.S_prophasm.k_31.d_na.M_default.C_xz
escherichia_coli.k32	0.3	prophasm	31	na	ones	bzip	48689681	1068469661	50585091	1017884570	35702346	33992666	1068469661	291239008	265146900	9055116	274202016	302740220	escherichia_coli.k32.r_0.3.S_prophasm.k_31.d_na.M_ones.C_bzip
escherichia_coli.k32	0.3	prophasm	31	na	ones	xz	48689681	1068469661	50585091	1017884570	35702346	33992666	1068469661	291239008	265146900	16516320	281663220	302740220	escherichia_coli.k32.r_0.3.S_prophasm.k_31.d_na.M_ones.C_xz
escherichia_coli.k32	0.3	prophasm	31	na	runsapprox	bzip	48689681	1068469661	50585091	1017884570	35702346	33992666	1068469661	291239008	265146900	9055116	274202016	302740220	escherichia_coli.k32.r_0.3.S_prophasm.k_31.d_na.M_runsapprox.C_bzip
escherichia_coli.k32	0.3	prophasm	31	na	runsapprox	xz	48689681	1068469661	50585091	1017884570	35702346	33992666	1068469661	291239008	265146900	16516320	281663220	302740220	escherichia_coli.k32.r_0.3.S_prophasm.k_31.d_na.M_runsapprox.C_xz
escherichia_coli.k32	0.4	prophasm	31	na	default	bzip	64919574	1230909834	64919574	1165990260	38866342	38866342	1230909834	335482696	304992584	9722727	314715311	348555440	escherichia_coli.k32.r_0.4.S_prophasm.k_31.d_na.M_default.C_bzip
escherichia_coli.k32	0.4	prophasm	31	na	default	xz	64919574	1230909834	64919574	1165990260	38866342	38866342	1230909834	335482696	304992584	17371340	322363924	348555440	escherichia_coli.k32.r_0.4.S_prophasm.k_31.d_na.M_default.C_xz
escherichia_coli.k32	0.4	prophasm	31	na	ones	bzip	64919574	1230909834	67832943	1163076891	41389257	38866342	1230909834	335482696	304992584	13060627	318053211	351223260	escherichia_coli.k32.r_0.4.S_prophasm.k_31.d_na.M_ones.C_bzip
escherichia_coli.k32	0.4	prophasm	31	na	ones	xz	64919574	1230909834	67832943	1163076891	41389257	38866342	1230909834	335482696	304992584	22928628	327921212	351223260	escherichia_coli.k32.r_0.4.S_prophasm.k_31.d_na.M_ones.C_xz
escherichia_coli.k32	0.4	prophasm	31	na	runsapprox	bzip	64919574	1230909834	67832943	1163076891	41389257	38866342	1230909834	335482696	304992584	13060627	318053211	351223260	escherichia_coli.k32.r_0.4.S_prophasm.k_31.d_na.M_runsapprox.C_bzip
escherichia_coli.k32	0.4	prophasm	31	na	runsapprox	xz	64919574	1230909834	67832943	1163076891	41389257	38866342	1230909834	335482696	304992584	22928628	327921212	351223260	escherichia_coli.k32.r_0.4.S_prophasm.k_31.d_na.M_runsapprox.C_xz
escherichia_coli.k32	0.5	prophasm	31	na	default	bzip	81149468	1297960058	81149468	1216810590	40560353	40560353	1297960058	353258952	321220056	12287800	333507856	369774660	escherichia_coli.k32.r_0.5.S_prophasm.k_31.d_na.M_default.C_bzip
escherichia_coli.k32	0.5	prophasm	31	na	default	xz	81149468	1297960058	81149468	1216810590	40560353	40560353	1297960058	353258952	321220056	21650756	342870812	369774660	escherichia_coli.k32.r_0.5.S_prophasm.k_31.d_na.M_default.C_xz
escherichia_coli.k32	0.5	prophasm	31	na	ones	bzip	81149468	1297960058	84986455	1212973603	43734259	40560353	1297960058	353258952	321220056	16513654	337733710	373211804	escherichia_coli.k32.r_0.5.S_prophasm.k_31.d_na.M_ones.C_bzip
escherichia_coli.k32	0.5	prophasm	31	na	ones	xz	81149468	1297960058	84986455	1212973603	43734259	40560353	1297960058	353258952	321220056	27967128	349187184	373211804	escherichia_coli.k32.r_0.5.S_prophasm.k_31.d_na.M_ones.C_xz
escherichia_coli.k32	0.5	prophasm	31	na	runsapprox	bzip	81149468	1297960058	84986455	1212973603	43734259	40560353	1297960058	353258952	321220056	16513654	337733710	373211804	escherichia_coli.k32.r_0.5.S_prophasm.k_31.d_na.M_runsapprox.C_bzip
escherichia_coli.k32	0.5	prophasm	31	na	runsapprox	xz	81149468	1297960058	84986455	1212973603	43734259	40560353	1297960058	353258952	321220056	27967128	349187184	373211804	escherichia_coli.k32.r_0.5.S_prophasm.k_31.d_na.M_runsapprox.C_xz
escherichia_coli.k32	0.6	prophasm	31	na	default	bzip	97379362	1270349752	97379362	1172970390	39099013	39099013	1270349752	345159408	313832068	14000177	327832245	364364668	escherichia_coli.k32.r_0.6.S_prophasm.k_31.d_na.M_default.C_bzip
escherichia_coli.k32	0.6	prophasm	31	na	default	xz	97379362	1270349752	97379362	1172970390	39099013	39099013	1270349752	345159408	313832068	24398700	338230768	364364668	escherichia_coli.k32.r_0.6.S_prophasm.k_31.d_na.M_default.C_xz
escherichia_coli.k32	0.6	prophasm	31	na	ones	bzip	97379362	1270349752	101893069	1168456683	42634166	39099013	1270349752	345159408	313832068	18799409	332631477	368246040	escherichia_coli.k32.r_0.6.S_prophasm.k_31.d_na.M_ones.C_bzip
escherichia_coli.k32	0.6	prophasm	31	na	ones	xz	97379362	1270349752	101893069	1168456683	42634166	39099013	1270349752	345159408	313832068	30867468	344699536	368246040	escherichia_coli.k32.r_0.6.S_prophasm.k_31.d_na.M_ones.C_xz
escherichia_coli.k32	0.6	prophasm	31	na	runsapprox	bzip	97379362	1270349752	101893069	1168456683	42634166	39099013	1270349752	345159408	313832068	18799409	332631477	368246040	escherichia_coli.k32.r_0.6.S_prophasm.k_31.d_na.M_runsapprox.C_bzip
escherichia_coli.k32	0.6	prophasm	31	na	runsapprox	xz	97379362	1270349752	101893069	1168456683	42634166	39099013	1270349752	345159408	313832068	30867468	344699536	368246040	escherichia_coli.k32.r_0.6.S_prophasm.k_31.d_na.M_runsapprox.C_xz
escherichia_coli.k32	0.7	prophasm	31	na	default	bzip	113609255	1148922935	113609255	1035313680	34510456	34510456	1148922935	310746576	282658816	14374368	297033184	331755448	escherichia_coli.k32.r_0.7.S_prophasm.k_31.d_na.M_default.C_bzip
escherichia_coli.k32	0.7	prophasm	31	na	default	xz	113609255	1148922935	113609255	1035313680	34510456	34510456	1148922935	310746576	282658816	24916144	307574960	331755448	escherichia_coli.k32.r_0.7.S_prophasm.k_31.d_na.M_default.C_xz
escherichia_coli.k32	0.7	prophasm	31	na	ones	bzip	113609255	1148922935	118376218	1030546717	37987471	34510456	1148922935	310746576	282658816	19266587	301925403	335742644	escherichia_coli.k32.r_0.7.S_prophasm.k_31.d_na.M_ones.C_bzip
escherichia_coli.k32	0.7	prophasm	31	na	ones	xz	113609255	1148922935	118376218	1030546717	37987471	34510456	1148922935	310746576	282658816	30912048	313570864	335742644	escherichia_coli.k32.r_0.7.S_prophasm.k_31.d_na.M_ones.C_xz
escherichia_coli.k32	0.7	prophasm	31	na	runsapprox	bzip	113609255	1148922935	118376218	1030546717	37987471	34510456	1148922935	310746576	282658816	19266587	301925403	335742644	escherichia_coli.k32.r_0.7.S_prophasm.k_31.d_na.M_runsapprox.C_bzip
escherichia_coli.k32	0.7	prophasm	31	na	runsapprox	xz	113609255	1148922935	118376218	1030546717	37987471	34510456	1148922935	310746576	282658816	30912048	313570864	335742644	escherichia_coli.k32.r_0.7.S_prophasm.k_31.d_na.M_runsapprox.C_xz
escherichia_coli.k32	0.8	prophasm	31	na	default	bzip	129839149	934013029	129839149	804173880	26805796	26805796	934013029	250548352	228304528	12966508	241271036	271715592	escherichia_coli.k32.r_0.8.S_prophasm.k_31.d_na.M_default.C_bzip
escherichia_coli.k32	0.8	prophasm	31	na	default	xz	129839149	934013029	129839149	804173880	26805796	26805796	934013029	250548352	228304528	22417372	250721900	271715592	escherichia_coli.k32.r_0.8.S_prophasm.k_31.d_na.M_default.C_xz
escherichia_coli.k32	0.8	prophasm	31	na	ones	bzip	129839149	934013029	134290400	799722629	29721610	26805796	934013029	250548352	228304528	17347413	245651941	275281324	escherichia_coli.k32.r_0.8.S_prophasm.k_31.d_na.M_ones.C_bzip
escherichia_coli.k32	0.8	prophasm	31	na	ones	xz	129839149	934013029	134290400	799722629	29721610	26805796	934013029	250548352	228304528	27344632	255649160	275281324	escherichia_coli.k32.r_0.8.S_prophasm.k_31.d_na.M_ones.C_xz
escherichia_coli.k32	0.8	prophasm	31	na	runsapprox	bzip	129839149	934013029	134290400	799722629	29721610	26805796	934013029	250548352	228304528	17347413	245651941	275281324	escherichia_coli.k32.r_0.8.S_prophasm.k_31.d_na.M_runsapprox.C_bzip
escherichia_coli.k32	0.8	prophasm	31	na	runsapprox	xz	129839149	934013029	134290400	799722629	29721610	26805796	934013029	250548352	228304528	27344632	255649160	275281324	escherichia_coli.k32.r_0.8.S_prophasm.k_31.d_na.M_runsapprox.C_xz
escherichia_coli.k32	0.9	prophasm	31	na	default	bzip	146069043	626408943	146069043	480339900	16011330	16011330	626408943	164524832	150624704	9308980	159933684	182402156	escherichia_coli.k32.r_0.9.S_prophasm.k_31.d_na.M_default.C_bzip
escherichia_coli.k32	0.9	prophasm	31	na	default	xz	146069043	626408943	146069043	480339900	16011330	16011330	626408943	164524832	150624704	16007184	166631888	182402156	escherichia_coli.k32.r_0.9.S_prophasm.k_31.d_na.M_default.C_xz
escherichia_coli.k32	0.9	prophasm	31	na	ones	bzip	146069043	626408943	149483220	476925723	17788857	16011330	626408943	164524832	150624704	12431923	163056627	184807304	escherichia_coli.k32.r_0.9.S_prophasm.k_31.d_na.M_ones.C_bzip
escherichia_coli.k32	0.9	prophasm	31	na	ones	xz	146069043	626408943	149483220	476925723	17788857	16011330	626408943	164524832	150624704	19315284	169939988	184807304	escherichia_coli.k32.r_0.9.S_prophasm.k_31.d_na.M_ones.C_xz
escherichia_coli.k32	0.9	prophasm	31	na	runsapprox	bzip	146069043	626408943	149483220	476925723	17788857	16011330	626408943	164524832	150624704	12431923	163056627	184807304	escherichia_coli.k32.r_0.9.S_prophasm.k_31.d_na.M_runsapprox.C_bzip
escherichia_coli.k32	0.9	prophasm	31	na	runsapprox	xz	146069043	626408943	149483220	476925723	17788857	16011330	626408943	164524832	150624704	19315284	169939988	184807304	escherichia_coli.k32.r_0.9.S_prophasm.k_31.d_na.M_runsapprox.C_xz
escherichia_coli.k32	1.0	prophasm	31	na	default	bzip	162298937	226652747	162298937	64353810	2145127	2145127	226652747	49564516	47769848	1734026	49503874	55601812	escherichia_coli.k32.r_1.0.S_prophasm.k_31.d_na.M_default.C_bzip
escherichia_coli.k32	1.0	prophasm	31	na	default	xz	162298937	226652747	162298937	64353810	2145127	2145127	226652747	49564516	47769848	3286240	51056088	55601812	escherichia_coli.k32.r_1.0.S_prophasm.k_31.d_na.M_default.C_xz
escherichia_coli.k32	1.0	prophasm	31	na	ones	bzip	162298937	226652747	163801580	62851167	2148217	2145127	226652747	49564516	47769848	2319993	50089841	55765508	escherichia_coli.k32.r_1.0.S_prophasm.k_31.d_na.M_ones.C_bzip
escherichia_coli.k32	1.0	prophasm	31	na	ones	xz	162298937	226652747	163801580	62851167	2148217	2145127	226652747	49564516	47769848	3940076	51709924	55765508	escherichia_coli.k32.r_1.0.S_prophasm.k_31.d_na.M_ones.C_xz
escherichia_coli.k32	1.0	prophasm	31	na	runsapprox	bzip	162298937	226652747	163801580	62851167	2148217	2145127	226652747	49564516	47769848	2319993	50089841	55765508	escherichia_coli.k32.r_1.0.S_prophasm.k_31.d_na.M_runsapprox.C_bzip
escherichia_coli.k32	1.0	prophasm	31	na	runsapprox	xz	162298937	226652747	163801580	62851167	2148217	2145127	226652747	49564516	47769848	3940076	51709924	55765508	escherichia_coli.k32.r_1.0.S_prophasm.k_31.d_na.M_runsapprox.C_xz
sars-cov-2_pangenome_k32	0.000000001	eulertigs	31	na	default	bzip	1	31	1	30	1	1	31	96	96	41	137	96	sars-cov-2_pangenome_k32.r_0.000000001.S_eulertigs.k_31.d_na.M_default.C_bzip
sars-cov-2_pangenome_k32	0.000000001	eulertigs	31	na	default	xz	1	31	1	30	1	1	31	96	96	76	172	96	sars-cov-2_pangenome_k32.r_0.000000001.S_eulertigs.k_31.d_na.M_default.C_xz
sars-cov-2_pangenome_k32	0.000000001	eulertigs	31	na	ones	bzip	1	31	1	30	1	1	31	96	96	41	137	96	sars-cov-2_pangenome_k32.r_0.000000001.S_eulertigs.k_31.d_na.M_ones.C_bzip
sars-cov-2_pangenome_k32	0.000000001	eulertigs	31	na	ones	xz	1	31	1	30	1	1	31	96	96	76	172	96	sars-cov-2_pangenome_k32.r_0.000000001.S_eulertigs.k_31.d_na.M_ones.C_xz
sars-cov-2_pangenome_k32	0.000000001	eulertigs	31	na	runsapprox	bzip	1	31	1	30	1	1	31	96	96	41	137	96	sars-cov-2_pangenome_k32.r_0.000000001.S_eulertigs.k_31.d_na.M_runsapprox.C_bzip
sars-cov-2_pangenome_k32	0.000000001	eulertigs	31	na	runsapprox	xz	1	31	1	30	1	1	31	96	96	76	172	96	sars-cov-2_pangenome_k32.r_0.000000001.S_eulertigs.k_31.d_na.M_runsapprox.C_xz
sars-cov-2_pangenome_k32	0.0001	eulertigs	31	na	default	bzip	1128	34938	1128	33810	1127	1127	34938	9916	9512	47	9559	9992	sars-cov-2_pangenome_k32.r_0.0001.S_eulertigs.k_31.d_na.M_default.C_bzip
sars-cov-2_pangenome_k32	0.0001	eulertigs	31	na	default	xz	1128	34938	1128	33810	1127	1127	34938	9916	9512	152	9664	9992	sars-cov-2_pangenome_k32.r_0.0001.S_eulertigs.k_31.d_na.M_default.C_xz
sars-cov-2_pangenome_k32	0.0001	eulertigs	31	na	ones	bzip	1128	34938	1128	33810	1127	1127	34938	9916	9512	47	9559	9992	sars-cov-2_pangenome_k32.r_0.0001.S_eulertigs.k_31.d_na.M_ones.C_bzip
sars-cov-2_pangenome_k32	0.0001	eulertigs	31	na	ones	xz	1128	34938	1128	33810	1127	1127	34938	9916	9512	152	9664	9992	sars-cov-2_pangenome_k32.r_0.0001.S_eulertigs.k_31.d_na.M_ones.C_xz
sars-cov-2_pangenome_k32	0.0001	eulertigs	31	na	runsapprox	bzip	1128	34938	1128	33810	1127	1127	34938	9916	9512	47	9559	9992	sars-cov-2_pangenome_k32.r_0.0001.S_eulertigs.k_31.d_na.M_runsapprox.C_bzip
sars-cov-2_pangenome_k32	0.0001	eulertigs	31	na	runsapprox	xz	1128	34938	1128	33810	1127	1127	34938	9916	9512	152	9664	9992	sars-cov-2_pangenome_k32.r_0.0001.S_eulertigs.k_31.d_na.M_runsapprox.C_xz
sars-cov-2_pangenome_k32	0.001	eulertigs	31	na	default	bzip	11283	349443	11283	338160	11272	11272	349443	86832	80600	71	80671	89236	sars-cov-2_pangenome_k32.r_0.001.S_eulertigs.k_31.d_na.M_default.C_bzip
sars-cov-2_pangenome_k32	0.001	eulertigs	31	na	default	xz	11283	349443	11283	338160	11272	11272	349443	86832	80600	248	80848	89236	sars-cov-2_pangenome_k32.r_0.001.S_eulertigs.k_31.d_na.M_default.C_xz
sars-cov-2_pangenome_k32	0.001	eulertigs	31	na	ones	bzip	11283	349443	11286	338157	11275	11272	349443	86832	80600	85	80685	89244	sars-cov-2_pangenome_k32.r_0.001.S_eulertigs.k_31.d_na.M_ones.C_bzip
sars-cov-2_pangenome_k32	0.001	eulertigs	31	na	ones	xz	11283	349443	11286	338157	11275	11272	349443	86832	80600	268	80868	89244	sars-cov-2_pangenome_k32.r_0.001.S_eulertigs.k_31.d_na.M_ones.C_xz
sars-cov-2_pangenome_k32	0.001	eulertigs	31	na	runsapprox	bzip	11283	349443	11286	338157	11275	11272	349443	86832	80600	85	80685	89244	sars-cov-2_pangenome_k32.r_0.001.S_eulertigs.k_31.d_na.M_runsapprox.C_bzip
sars-cov-2_pangenome_k32	0.001	eulertigs	31	na	runsapprox	xz	11283	349443	11286	338157	11275	11272	349443	86832	80600	268	80868	89244	sars-cov-2_pangenome_k32.r_0.001.S_eulertigs.k_31.d_na.M_runsapprox.C_xz
sars-cov-2_pangenome_k32	0.01	eulertigs	31	na	default	bzip	112839	3463059	112839	3350220	111674	111674	3463059	748060	688216	2046	690262	761112	sars-cov-2_pangenome_k32.r_0.01.S_eulertigs.k_31.d_na.M_default.C_bzip
sars-cov-2_pangenome_k32	0.01	eulertigs	31	na	default	xz	112839	3463059	112839	3350220	111674	111674	3463059	748060	688216	4036	692252	761112	sars-cov-2_pangenome_k32.r_0.01.S_eulertigs.k_31.d_na.M_default.C_xz
sars-cov-2_pangenome_k32	0.01	eulertigs	31	na	ones	bzip	112839	3463059	113172	3349887	112004	111674	3463059	748060	688216	2758	690974	761592	sars-cov-2_pangenome_k32.r_0.01.S_eulertigs.k_31.d_na.M_ones.C_bzip
sars-cov-2_pangenome_k32	0.01	eulertigs	31	na	ones	xz	112839	3463059	113172	3349887	112004	111674	3463059	748060	688216	5656	693872	761592	sars-cov-2_pangenome_k32.r_0.01.S_eulertigs.k_31.d_na.M_ones.C_xz
sars-cov-2_pangenome_k32	0.01	eulertigs	31	na	runsapprox	bzip	112839	3463059	113172	3349887	112004	111674	3463059	748060	688216	2758	690974	761592	sars-cov-2_pangenome_k32.r_0.01.S_eulertigs.k_31.d_na.M_runsapprox.C_bzip
sars-cov-2_pangenome_k32	0.01	eulertigs	31	na	runsapprox	xz	112839	3463059	113172	3349887	112004	111674	3463059	748060	688216	5656	693872	761592	sars-cov-2_pangenome_k32.r_0.01.S_eulertigs.k_31.d_na.M_runsapprox.C_xz
sars-cov-2_pangenome_k32	0.05	eulertigs	31	na	default	bzip	564195	16594905	564195	16030710	534357	534357	16594905	3371076	3104412	34928	3139340	3446580	sars-cov-2_pangenome_k32.r_0.05.S_eulertigs.k_31.d_na.M_default.C_bzip
sars-cov-2_pangenome_k32	0.05	eulertigs	31	na	default	xz	564195	16594905	564195	16030710	534357	534357	16594905	3371076	3104412	63612	3168024	3446580	sars-cov-2_pangenome_k32.r_0.05.S_eulertigs.k_31.d_na.M_default.C_xz
sars-cov-2_pangenome_k32	0.05	eulertigs	31	na	ones	bzip	564195	16594905	572115	16022790	542097	534357	16594905	3371076	3104412	47992	3152404	3453684	sars-cov-2_pangenome_k32.r_0.05.S_eulertigs.k_31.d_na.M_ones.C_bzip
sars-cov-2_pangenome_k32	0.05	eulertigs	31	na	ones	xz	564195	16594905	572115	16022790	542097	534357	16594905	3371076	3104412	93124	3197536	3453684	sars-cov-2_pangenome_k32.r_0.05.S_eulertigs.k_31.d_na.M_ones.C_xz
sars-cov-2_pangenome_k32	0.05	eulertigs	31	na	runsapprox	bzip	564195	16594905	572115	16022790	542097	534357	16594905	3371076	3104412	47992	3152404	3453684	sars-cov-2_pangenome_k32.r_0.05.S_eulertigs.k_31.d_na.M_runsapprox.C_bzip
sars-cov-2_pangenome_k32	0.05	eulertigs	31	na	runsapprox	xz	564195	16594905	572115	16022790	542097	534357	16594905	3371076	3104412	93124	3197536	3453684	sars-cov-2_pangenome_k32.r_0.05.S_eulertigs.k_31.d_na.M_runsapprox.C_xz
sars-cov-2_pangenome_k32	0.1	eulertigs	31	na	default	bzip	1128390	31430310	1128390	30301920	1010064	1010064	31430310	6244992	5737488	104913	5842401	6421692	sars-cov-2_pangenome_k32.r_0.1.S_eulertigs.k_31.d_na.M_default.C_bzip
sars-cov-2_pangenome_k32	0.1	eulertigs	31	na	default	xz	1128390	31430310	1128390	30301920	1010064	1010064	31430310	6244992	5737488	194088	5931576	6421692	sars-cov-2_pangenome_k32.r_0.1.S_eulertigs.k_31.d_na.M_default.C_xz
sars-cov-2_pangenome_k32	0.1	eulertigs	31	na	ones	bzip	1128390	31430310	1157485	30272825	1037685	1010064	31430310	6244992	5737488	148129	5885617	6443528	sars-cov-2_pangenome_k32.r_0.1.S_eulertigs.k_31.d_na.M_ones.C_bzip
sars-cov-2_pangenome_k32	0.1	eulertigs	31	na	ones	xz	1128390	31430310	1157485	30272825	1037685	1010064	31430310	6244992	5737488	284252	6021740	6443528	sars-cov-2_pangenome_k32.r_0.1.S_eulertigs.k_31.d_na.M_ones.C_xz
sars-cov-2_pangenome_k32	0.1	eulertigs	31	na	runsapprox	bzip	1128390	31430310	1157485	30272825	1037685	1010064	31430310	6244992	5737488	148129	5885617	6443528	sars-cov-2_pangenome_k32.r_0.1.S_eulertigs.k_31.d_na.M_runsapprox.C_bzip
sars-cov-2_pangenome_k32	0.1	eulertigs	31	na	runsapprox	xz	1128390	31430310	1157485	30272825	1037685	1010064	31430310	6244992	5737488	284252	6021740	6443528	sars-cov-2_pangenome_k32.r_0.1.S_eulertigs.k_31.d_na.M_runsapprox.C_xz
sars-cov-2_pangenome_k32	0.2	eulertigs	31	na	default	bzip	2256781	55925791	2256781	53669010	1788967	1788967	55925791	10785168	9875368	292416	10167784	11217088	sars-cov-2_pangenome_k32.r_0.2.S_eulertigs.k_31.d_na.M_default.C_bzip
sars-cov-2_pangenome_k32	0.2	eulertigs	31	na	default	xz	2256781	55925791	2256781	53669010	1788967	1788967	55925791	10785168	9875368	540668	10416036	11217088	sars-cov-2_pangenome_k32.r_0.2.S_eulertigs.k_31.d_na.M_default.C_xz
sars-cov-2_pangenome_k32	0.2	eulertigs	31	na	ones	bzip	2256781	55925791	2362295	53563496	1883962	1788967	55925791	10785168	9875368	429710	10305078	11304112	sars-cov-2_pangenome_k32.r_0.2.S_eulertigs.k_31.d_na.M_ones.C_bzip
sars-cov-2_pangenome_k32	0.2	eulertigs	31	na	ones	xz	2256781	55925791	2362295	53563496	1883962	1788967	55925791	10785168	9875368	792004	10667372	11304112	sars-cov-2_pangenome_k32.r_0.2.S_eulertigs.k_31.d_na.M_ones.C_xz
sars-cov-2_pangenome_k32	0.2	eulertigs	31	na	runsapprox	bzip	2256781	55925791	2362295	53563496	1883962	1788967	55925791	10785168	9875368	429710	10305078	11304112	sars-cov-2_pangenome_k32.r_0.2.S_eulertigs.k_31.d_na.M_runsapprox.C_bzip
sars-cov-2_pangenome_k32	0.2	eulertigs	31	na	runsapprox	xz	2256781	55925791	2362295	53563496	1883962	1788967	55925791	10785168	9875368	792004	10667372	11304112	sars-cov-2_pangenome_k32.r_0.2.S_eulertigs.k_31.d_na.M_runsapprox.C_xz
sars-cov-2_pangenome_k32	0.3	eulertigs	31	na	default	bzip	3385172	73777532	3385172	70392360	2346412	2346412	73777532	13973320	12767128	512487	13279615	14707560	sars-cov-2_pangenome_k32.r_0.3.S_eulertigs.k_31.d_na.M_default.C_bzip
sars-cov-2_pangenome_k32	0.3	eulertigs	31	na	default	xz	3385172	73777532	3385172	70392360	2346412	2346412	73777532	13973320	12767128	933484	13700612	14707560	sars-cov-2_pangenome_k32.r_0.3.S_eulertigs.k_31.d_na.M_default.C_xz
sars-cov-2_pangenome_k32	0.3	eulertigs	31	na	ones	bzip	3385172	73777532	3592580	70184952	2523041	2346412	73777532	13973320	12767128	761354	13528482	14866568	sars-cov-2_pangenome_k32.r_0.3.S_eulertigs.k_31.d_na.M_ones.C_bzip
sars-cov-2_pangenome_k32	0.3	eulertigs	31	na	ones	xz	3385172	73777532	3592580	70184952	2523041	2346412	73777532	13973320	12767128	1339252	14106380	14866568	sars-cov-2_pangenome_k32.r_0.3.S_eulertigs.k_31.d_na.M_ones.C_xz
sars-cov-2_pangenome_k32	0.3	eulertigs	31	na	runsapprox	bzip	3385172	73777532	3592580	70184952	2523041	2346412	73777532	13973320	12767128	761354	13528482	14866568	sars-cov-2_pangenome_k32.r_0.3.S_eulertigs.k_31.d_na.M_runsapprox.C_bzip
sars-cov-2_pangenome_k32	0.3	eulertigs	31	na	runsapprox	xz	3385172	73777532	3592580	70184952	2523041	2346412	73777532	13973320	12767128	1339252	14106380	14866568	sars-cov-2_pangenome_k32.r_0.3.S_eulertigs.k_31.d_na.M_runsapprox.C_xz
sars-cov-2_pangenome_k32	0.4	eulertigs	31	na	default	bzip	4513562	85109492	4513562	80595930	2686531	2686531	85109492	15953156	14582984	735030	15318014	16977928	sars-cov-2_pangenome_k32.r_0.4.S_eulertigs.k_31.d_na.M_default.C_bzip
sars-cov-2_pangenome_k32	0.4	eulertigs	31	na	default	xz	4513562	85109492	4513562	80595930	2686531	2686531	85109492	15953156	14582984	1321464	15904448	16977928	sars-cov-2_pangenome_k32.r_0.4.S_eulertigs.k_31.d_na.M_default.C_xz
sars-cov-2_pangenome_k32	0.4	eulertigs	31	na	ones	bzip	4513562	85109492	4837050	80272442	2946195	2686531	85109492	15953156	14582984	1101349	15684333	17223692	sars-cov-2_pangenome_k32.r_0.4.S_eulertigs.k_31.d_na.M_ones.C_bzip
sars-cov-2_pangenome_k32	0.4	eulertigs	31	na	ones	xz	4513562	85109492	4837050	80272442	2946195	2686531	85109492	15953156	14582984	1851300	16434284	17223692	sars-cov-2_pangenome_k32.r_0.4.S_eulertigs.k_31.d_na.M_ones.C_xz
sars-cov-2_pangenome_k32	0.4	eulertigs	31	na	runsapprox	bzip	4513562	85109492	4837050	80272442	2946195	2686531	85109492	15953156	14582984	1101349	15684333	17223692	sars-cov-2_pangenome_k32.r_0.4.S_eulertigs.k_31.d_na.M_runsapprox.C_bzip
sars-cov-2_pangenome_k32	0.4	eulertigs	31	na	runsapprox	xz	4513562	85109492	4837050	80272442	2946195	2686531	85109492	15953156	14582984	1851300	16434284	17223692	sars-cov-2_pangenome_k32.r_0.4.S_eulertigs.k_31.d_na.M_runsapprox.C_xz
sars-cov-2_pangenome_k32	0.5	eulertigs	31	na	default	bzip	5641953	90015213	5641953	84373260	2812442	2812442	90015213	16795960	15243232	934378	16177610	18089936	sars-cov-2_pangenome_k32.r_0.5.S_eulertigs.k_31.d_na.M_default.C_bzip
sars-cov-2_pangenome_k32	0.5	eulertigs	31	na	default	xz	5641953	90015213	5641953	84373260	2812442	2812442	90015213	16795960	15243232	1658600	16901832	18089936	sars-cov-2_pangenome_k32.r_0.5.S_eulertigs.k_31.d_na.M_default.C_xz
sars-cov-2_pangenome_k32	0.5	eulertigs	31	na	ones	bzip	5641953	90015213	6077649	83937564	3138674	2812442	90015213	16795960	15243232	1400933	16644165	18397708	sars-cov-2_pangenome_k32.r_0.5.S_eulertigs.k_31.d_na.M_ones.C_bzip
sars-cov-2_pangenome_k32	0.5	eulertigs	31	na	ones	xz	5641953	90015213	6077649	83937564	3138674	2812442	90015213	16795960	15243232	2259436	17502668	18397708	sars-cov-2_pangenome_k32.r_0.5.S_eulertigs.k_31.d_na.M_ones.C_xz
sars-cov-2_pangenome_k32	0.5	eulertigs	31	na	runsapprox	bzip	5641953	90015213	6077649	83937564	3138674	2812442	90015213	16795960	15243232	1400933	16644165	18397708	sars-cov-2_pangenome_k32.r_0.5.S_eulertigs.k_31.d_na.M_runsapprox.C_bzip
sars-cov-2_pangenome_k32	0.5	eulertigs	31	na	runsapprox	xz	5641953	90015213	6077649	83937564	3138674	2812442	90015213	16795960	15243232	2259436	17502668	18397708	sars-cov-2_pangenome_k32.r_0.5.S_eulertigs.k_31.d_na.M_runsapprox.C_xz
sars-cov-2_pangenome_k32	0.6	eulertigs	31	na	default	bzip	6770344	88656604	6770344	81886260	2729542	2729542	88656604	16472400	15061524	1081856	16143380	17972552	sars-cov-2_pangenome_k32.r_0.6.S_eulertigs.k_31.d_na.M_default.C_bzip
sars-cov-2_pangenome_k32	0.6	eulertigs	31	na	default	xz	6770344	88656604	6770344	81886260	2729542	2729542	88656604	16472400	15061524	1889464	16950988	17972552	sars-cov-2_pangenome_k32.r_0.6.S_eulertigs.k_31.d_na.M_default.C_xz
sars-cov-2_pangenome_k32	0.6	eulertigs	31	na	ones	bzip	6770344	88656604	7304879	81351725	3097072	2729542	88656604	16472400	15061524	1619953	16681477	18342096	sars-cov-2_pangenome_k32.r_0.6.S_eulertigs.k_31.d_na.M_ones.C_bzip
sars-cov-2_pangenome_k32	0.6	eulertigs	31	na	ones	xz	6770344	88656604	7304879	81351725	3097072	2729542	88656604	16472400	15061524	2508668	17570192	18342096	sars-cov-2_pangenome_k32.r_0.6.S_eulertigs.k_31.d_na.M_ones.C_xz
sars-cov-2_pangenome_k32	0.6	eulertigs	31	na	runsapprox	bzip	6770344	88656604	7304879	81351725	3097072	2729542	88656604	16472400	15061524	1619953	16681477	18342096	sars-cov-2_pangenome_k32.r_0.6.S_eulertigs.k_31.d_na.M_runsapprox.C_bzip
sars-cov-2_pangenome_k32	0.6	eulertigs	31	na	runsapprox	xz	6770344	88656604	7304879	81351725	3097072	2729542	88656604	16472400	15061524	2508668	17570192	18342096	sars-cov-2_pangenome_k32.r_0.6.S_eulertigs.k_31.d_na.M_runsapprox.C_xz
sars-cov-2_pangenome_k32	0.7	eulertigs	31	na	default	bzip	7898734	81062554	7898734	73163820	2438794	2438794	81062554	15016560	13668664	1134426	14803090	16625776	sars-cov-2_pangenome_k32.r_0.7.S_eulertigs.k_31.d_na.M_default.C_bzip
sars-cov-2_pangenome_k32	0.7	eulertigs	31	na	default	xz	7898734	81062554	7898734	73163820	2438794	2438794	81062554	15016560	13668664	1953292	15621956	16625776	sars-cov-2_pangenome_k32.r_0.7.S_eulertigs.k_31.d_na.M_default.C_xz
sars-cov-2_pangenome_k32	0.7	eulertigs	31	na	ones	bzip	7898734	81062554	8495641	72566913	2807031	2438794	81062554	15016560	13668664	1698183	15366847	17026428	sars-cov-2_pangenome_k32.r_0.7.S_eulertigs.k_31.d_na.M_ones.C_bzip
sars-cov-2_pangenome_k32	0.7	eulertigs	31	na	ones	xz	7898734	81062554	8495641	72566913	2807031	2438794	81062554	15016560	13668664	2538804	16207468	17026428	sars-cov-2_pangenome_k32.r_0.7.S_eulertigs.k_31.d_na.M_ones.C_xz
sars-cov-2_pangenome_k32	0.7	eulertigs	31	na	runsapprox	bzip	7898734	81062554	8495641	72566913	2807031	2438794	81062554	15016560	13668664	1698183	15366847	17026428	sars-cov-2_pangenome_k32.r_0.7.S_eulertigs.k_31.d_na.M_runsapprox.C_bzip
sars-cov-2_pangenome_k32	0.7	eulertigs	31	na	runsapprox	xz	7898734	81062554	8495641	72566913	2807031	2438794	81062554	15016560	13668664	2538804	16207468	17026428	sars-cov-2_pangenome_k32.r_0.7.S_eulertigs.k_31.d_na.M_runsapprox.C_xz
sars-cov-2_pangenome_k32	0.8	eulertigs	31	na	default	bzip	9027125	67315385	9027125	58288260	1942942	1942942	67315385	12402888	11341444	1056745	12398189	13948872	sars-cov-2_pangenome_k32.r_0.8.S_eulertigs.k_31.d_na.M_default.C_bzip
sars-cov-2_pangenome_k32	0.8	eulertigs	31	na	default	xz	9027125	67315385	9027125	58288260	1942942	1942942	67315385	12402888	11341444	1790792	13132236	13948872	sars-cov-2_pangenome_k32.r_0.8.S_eulertigs.k_31.d_na.M_default.C_xz
sars-cov-2_pangenome_k32	0.8	eulertigs	31	na	ones	bzip	9027125	67315385	9642924	57672461	2267487	1942942	67315385	12402888	11341444	1587059	12928503	14342960	sars-cov-2_pangenome_k32.r_0.8.S_eulertigs.k_31.d_na.M_ones.C_bzip
sars-cov-2_pangenome_k32	0.8	eulertigs	31	na	ones	xz	9027125	67315385	9642924	57672461	2267487	1942942	67315385	12402888	11341444	2299272	13640716	14342960	sars-cov-2_pangenome_k32.r_0.8.S_eulertigs.k_31.d_na.M_ones.C_xz
sars-cov-2_pangenome_k32	0.8	eulertigs	31	na	runsapprox	bzip	9027125	67315385	9642924	57672461	2267487	1942942	67315385	12402888	11341444	1587059	12928503	14342960	sars-cov-2_pangenome_k32.r_0.8.S_eulertigs.k_31.d_na.M_runsapprox.C_bzip
sars-cov-2_pangenome_k32	0.8	eulertigs	31	na	runsapprox	xz	9027125	67315385	9642924	57672461	2267487	1942942	67315385	12402888	11341444	2299272	13640716	14342960	sars-cov-2_pangenome_k32.r_0.8.S_eulertigs.k_31.d_na.M_runsapprox.C_xz
sars-cov-2_pangenome_k32	0.9	eulertigs	31	na	default	bzip	10155516	47502996	10155516	37347480	1244916	1244916	47502996	8559252	7882008	801949	8683957	9797680	sars-cov-2_pangenome_k32.r_0.9.S_eulertigs.k_31.d_na.M_default.C_bzip
sars-cov-2_pangenome_k32	0.9	eulertigs	31	na	default	xz	10155516	47502996	10155516	37347480	1244916	1244916	47502996	8559252	7882008	1328356	9210364	9797680	sars-cov-2_pangenome_k32.r_0.9.S_eulertigs.k_31.d_na.M_default.C_xz
sars-cov-2_pangenome_k32	0.9	eulertigs	31	na	ones	bzip	10155516	47502996	10727341	36775655	1474663	1244916	47502996	8559252	7882008	1227729	9109737	10113324	sars-cov-2_pangenome_k32.r_0.9.S_eulertigs.k_31.d_na.M_ones.C_bzip
sars-cov-2_pangenome_k32	0.9	eulertigs	31	na	ones	xz	10155516	47502996	10727341	36775655	1474663	1244916	47502996	8559252	7882008	1720912	9602920	10113324	sars-cov-2_pangenome_k32.r_0.9.S_eulertigs.k_31.d_na.M_ones.C_xz
sars-cov-2_pangenome_k32	0.9	eulertigs	31	na	runsapprox	bzip	10155516	47502996	10727341	36775655	1474663	1244916	47502996	8559252	7882008	1227729	9109737	10113324	sars-cov-2_pangenome_k32.r_0.9.S_eulertigs.k_31.d_na.M_runsapprox.C_bzip
sars-cov-2_pangenome_k32	0.9	eulertigs	31	na	runsapprox	xz	10155516	47502996	10727341	36775655	1474663	1244916	47502996	8559252	7882008	1720912	9602920	10113324	sars-cov-2_pangenome_k32.r_0.9.S_eulertigs.k_31.d_na.M_runsapprox.C_xz
sars-cov-2_pangenome_k32	1.0	eulertigs	31	na	default	bzip	11283907	21558487	11283907	10274580	342486	342486	21558487	3181188	3014440	286937	3301377	3563376	sars-cov-2_pangenome_k32.r_1.0.S_eulertigs.k_31.d_na.M_default.C_bzip
sars-cov-2_pangenome_k32	1.0	eulertigs	31	na	default	xz	11283907	21558487	11283907	10274580	342486	342486	21558487	3181188	3014440	513468	3527908	3563376	sars-cov-2_pangenome_k32.r_1.0.S_eulertigs.k_31.d_na.M_default.C_xz
sars-cov-2_pangenome_k32	1.0	eulertigs	31	na	ones	bzip	11283907	21558487	11733232	9825255	421375	342486	21558487	3181188	3014440	478927	3493367	3719816	sars-cov-2_pangenome_k32.r_1.0.S_eulertigs.k_31.d_na.M_ones.C_bzip
sars-cov-2_pangenome_k32	1.0	eulertigs	31	na	ones	xz	11283907	21558487	11733232	9825255	421375	342486	21558487	3181188	3014440	705568	3720008	3719816	sars-cov-2_pangenome_k32.r_1.0.S_eulertigs.k_31.d_na.M_ones.C_xz
sars-cov-2_pangenome_k32	1.0	eulertigs	31	na	runsapprox	bzip	11283907	21558487	11733232	9825255	421375	342486	21558487	3181188	3014440	478927	3493367	3719816	sars-cov-2_pangenome_k32.r_1.0.S_eulertigs.k_31.d_na.M_runsapprox.C_bzip
sars-cov-2_pangenome_k32	1.0	eulertigs	31	na	runsapprox	xz	11283907	21558487	11733232	9825255	421375	342486	21558487	3181188	3014440	705568	3720008	3719816	sars-cov-2_pangenome_k32.r_1.0.S_eulertigs.k_31.d_na.M_runsapprox.C_xz
sars-cov-2_pangenome_k32	0.000000001	greedytigs	31	na	default	bzip	1	31	1	30	1	1	31	96	96	41	137	96	sars-cov-2_pangenome_k32.r_0.000000001.S_greedytigs.k_31.d_na.M_default.C_bzip
sars-cov-2_pangenome_k32	0.000000001	greedytigs	31	na	default	xz	1	31	1	30	1	1	31	96	96	76	172	96	sars-cov-2_pangenome_k32.r_0.000000001.S_greedytigs.k_31.d_na.M_default.C_xz
sars-cov-2_pangenome_k32	0.000000001	greedytigs	31	na	ones	bzip	1	31	1	30	1	1	31	96	96	41	137	96	sars-cov-2_pangenome_k32.r_0.000000001.S_greedytigs.k_31.d_na.M_ones.C_bzip
sars-cov-2_pangenome_k32	0.000000001	greedytigs	31	na	ones	xz	1	31	1	30	1	1	31	96	96	76	172	96	sars-cov-2_pangenome_k32.r_0.000000001.S_greedytigs.k_31.d_na.M_ones.C_xz
sars-cov-2_pangenome_k32	0.000000001	greedytigs	31	na	runsapprox	bzip	1	31	1	30	1	1	31	96	96	41	137	96	sars-cov-2_pangenome_k32.r_0.000000001.S_greedytigs.k_31.d_na.M_runsapprox.C_bzip
sars-cov-2_pangenome_k32	0.000000001	greedytigs	31	na	runsapprox	xz	1	31	1	30	1	1	31	96	96	76	172	96	sars-cov-2_pangenome_k32.r_0.000000001.S_greedytigs.k_31.d_na.M_runsapprox.C_xz
sars-cov-2_pangenome_k32	0.0001	greedytigs	31	na	default	bzip	1128	34938	1128	33810	1127	1127	34938	9916	9512	47	9559	9992	sars-cov-2_pangenome_k32.r_0.0001.S_greedytigs.k_31.d_na.M_default.C_bzip
sars-cov-2_pangenome_k32	0.0001	greedytigs	31	na	default	xz	1128	34938	1128	33810	1127	1127	34938	9916	9512	152	9664	9992	sars-cov-2_pangenome_k32.r_0.0001.S_greedytigs.k_31.d_na.M_default.C_xz
sars-cov-2_pangenome_k32	0.0001	greedytigs	31	na	ones	bzip	1128	34938	1128	33810	1127	1127	34938	9916	9512	47	9559	9992	sars-cov-2_pangenome_k32.r_0.0001.S_greedytigs.k_31.d_na.M_ones.C_bzip
sars-cov-2_pangenome_k32	0.0001	greedytigs	31	na	ones	xz	1128	34938	1128	33810	1127	1127	34938	9916	9512	152	9664	9992	sars-cov-2_pangenome_k32.r_0.0001.S_greedytigs.k_31.d_na.M_ones.C_xz
sars-cov-2_pangenome_k32	0.0001	greedytigs	31	na	runsapprox	bzip	1128	34938	1128	33810	1127	1127	34938	9916	9512	47	9559	9992	sars-cov-2_pangenome_k32.r_0.0001.S_greedytigs.k_31.d_na.M_runsapprox.C_bzip
sars-cov-2_pangenome_k32	0.0001	greedytigs	31	na	runsapprox	xz	1128	34938	1128	33810	1127	1127	34938	9916	9512	152	9664	9992	sars-cov-2_pangenome_k32.r_0.0001.S_greedytigs.k_31.d_na.M_runsapprox.C_xz
sars-cov-2_pangenome_k32	0.001	greedytigs	31	na	default	bzip	11283	349443	11283	338160	11272	11272	349443	86832	80600	71	80671	89236	sars-cov-2_pangenome_k32.r_0.001.S_greedytigs.k_31.d_na.M_default.C_bzip
sars-cov-2_pangenome_k32	0.001	greedytigs	31	na	default	xz	11283	349443	11283	338160	11272	11272	349443	86832	80600	248	80848	89236	sars-cov-2_pangenome_k32.r_0.001.S_greedytigs.k_31.d_na.M_default.C_xz
sars-cov-2_pangenome_k32	0.001	greedytigs	31	na	ones	bzip	11283	349443	11286	338157	11275	11272	349443	86832	80600	85	80685	89244	sars-cov-2_pangenome_k32.r_0.001.S_greedytigs.k_31.d_na.M_ones.C_bzip
sars-cov-2_pangenome_k32	0.001	greedytigs	31	na	ones	xz	11283	349443	11286	338157	11275	11272	349443	86832	80600	268	80868	89244	sars-cov-2_pangenome_k32.r_0.001.S_greedytigs.k_31.d_na.M_ones.C_xz
sars-cov-2_pangenome_k32	0.001	greedytigs	31	na	runsapprox	bzip	11283	349443	11286	338157	11275	11272	349443	86832	80600	85	80685	89244	sars-cov-2_pangenome_k32.r_0.001.S_greedytigs.k_31.d_na.M_runsapprox.C_bzip
sars-cov-2_pangenome_k32	0.001	greedytigs	31	na	runsapprox	xz	11283	349443	11286	338157	11275	11272	349443	86832	80600	268	80868	89244	sars-cov-2_pangenome_k32.r_0.001.S_greedytigs.k_31.d_na.M_runsapprox.C_xz
sars-cov-2_pangenome_k32	0.01	greedytigs	31	na	default	bzip	112839	3463059	112839	3350220	111674	111674	3463059	748060	688216	2046	690262	761112	sars-cov-2_pangenome_k32.r_0.01.S_greedytigs.k_31.d_na.M_default.C_bzip
sars-cov-2_pangenome_k32	0.01	greedytigs	31	na	default	xz	112839	3463059	112839	3350220	111674	111674	3463059	748060	688216	4036	692252	761112	sars-cov-2_pangenome_k32.r_0.01.S_greedytigs.k_31.d_na.M_default.C_xz
sars-cov-2_pangenome_k32	0.01	greedytigs	31	na	ones	bzip	112839	3463059	113172	3349887	112004	111674	3463059	748060	688216	2758	690974	761592	sars-cov-2_pangenome_k32.r_0.01.S_greedytigs.k_31.d_na.M_ones.C_bzip
sars-cov-2_pangenome_k32	0.01	greedytigs	31	na	ones	xz	112839	3463059	113172	3349887	112004	111674	3463059	748060	688216	5656	693872	761592	sars-cov-2_pangenome_k32.r_0.01.S_greedytigs.k_31.d_na.M_ones.C_xz
sars-cov-2_pangenome_k32	0.01	greedytigs	31	na	runsapprox	bzip	112839	3463059	113172	3349887	112004	111674	3463059	748060	688216	2758	690974	761592	sars-cov-2_pangenome_k32.r_0.01.S_greedytigs.k_31.d_na.M_runsapprox.C_bzip
sars-cov-2_pangenome_k32	0.01	greedytigs	31	na	runsapprox	xz	112839	3463059	113172	3349887	112004	111674	3463059	748060	688216	5656	693872	761592	sars-cov-2_pangenome_k32.r_0.01.S_greedytigs.k_31.d_na.M_runsapprox.C_xz
sars-cov-2_pangenome_k32	0.05	greedytigs	31	na	default	bzip	564195	16594905	564195	16030710	534357	534357	16594905	3371076	3104412	34928	3139340	3446580	sars-cov-2_pangenome_k32.r_0.05.S_greedytigs.k_31.d_na.M_default.C_bzip
sars-cov-2_pangenome_k32	0.05	greedytigs	31	na	default	xz	564195	16594905	564195	16030710	534357	534357	16594905	3371076	3104412	63612	3168024	3446580	sars-cov-2_pangenome_k32.r_0.05.S_greedytigs.k_31.d_na.M_default.C_xz
sars-cov-2_pangenome_k32	0.05	greedytigs	31	na	ones	bzip	564195	16594905	572115	16022790	542097	534357	16594905	3371076	3104412	47992	3152404	3453684	sars-cov-2_pangenome_k32.r_0.05.S_greedytigs.k_31.d_na.M_ones.C_bzip
sars-cov-2_pangenome_k32	0.05	greedytigs	31	na	ones	xz	564195	16594905	572115	16022790	542097	534357	16594905	3371076	3104412	93124	3197536	3453684	sars-cov-2_pangenome_k32.r_0.05.S_greedytigs.k_31.d_na.M_ones.C_xz
sars-cov-2_pangenome_k32	0.05	greedytigs	31	na	runsapprox	bzip	564195	16594905	572115	16022790	542097	534357	16594905	3371076	3104412	47992	3152404	3453684	sars-cov-2_pangenome_k32.r_0.05.S_greedytigs.k_31.d_na.M_runsapprox.C_bzip
sars-cov-2_pangenome_k32	0.05	greedytigs	31	na	runsapprox	xz	564195	16594905	572115	16022790	542097	534357	16594905	3371076	3104412	93124	3197536	3453684	sars-cov-2_pangenome_k32.r_0.05.S_greedytigs.k_31.d_na.M_runsapprox.C_xz
sars-cov-2_pangenome_k32	0.1	greedytigs	31	na	default	bzip	1128390	31429875	1128405	30301470	1010049	1010049	31429875	6246332	5730624	105053	5835677	6422912	sars-cov-2_pangenome_k32.r_0.1.S_greedytigs.k_31.d_na.M_default.C_bzip
sars-cov-2_pangenome_k32	0.1	greedytigs	31	na	default	xz	1128390	31429875	1128405	30301470	1010049	1010049	31429875	6246332	5730624	194304	5924928	6422912	sars-cov-2_pangenome_k32.r_0.1.S_greedytigs.k_31.d_na.M_default.C_xz
sars-cov-2_pangenome_k32	0.1	greedytigs	31	na	ones	bzip	1128390	31429875	1157759	30272116	1037968	1010049	31429875	6246332	5730624	148468	5879092	6448172	sars-cov-2_pangenome_k32.r_0.1.S_greedytigs.k_31.d_na.M_ones.C_bzip
sars-cov-2_pangenome_k32	0.1	greedytigs	31	na	ones	xz	1128390	31429875	1157759	30272116	1037968	1010049	31429875	6246332	5730624	284876	6015500	6448172	sars-cov-2_pangenome_k32.r_0.1.S_greedytigs.k_31.d_na.M_ones.C_xz
sars-cov-2_pangenome_k32	0.1	greedytigs	31	na	runsapprox	bzip	1128390	31429875	1157759	30272116	1037968	1010049	31429875	6246332	5730624	148468	5879092	6448172	sars-cov-2_pangenome_k32.r_0.1.S_greedytigs.k_31.d_na.M_runsapprox.C_bzip
sars-cov-2_pangenome_k32	0.1	greedytigs	31	na	runsapprox	xz	1128390	31429875	1157759	30272116	1037968	1010049	31429875	6246332	5730624	284876	6015500	6448172	sars-cov-2_pangenome_k32.r_0.1.S_greedytigs.k_31.d_na.M_runsapprox.C_xz
sars-cov-2_pangenome_k32	0.2	greedytigs	31	na	default	bzip	2256781	55917706	2257126	53660580	1788686	1788686	55917706	10781812	9883244	292643	10175887	11218956	sars-cov-2_pangenome_k32.r_0.2.S_greedytigs.k_31.d_na.M_default.C_bzip
sars-cov-2_pangenome_k32	0.2	greedytigs	31	na	default	xz	2256781	55917706	2257126	53660580	1788686	1788686	55917706	10781812	9883244	541412	10424656	11218956	sars-cov-2_pangenome_k32.r_0.2.S_greedytigs.k_31.d_na.M_default.C_xz
sars-cov-2_pangenome_k32	0.2	greedytigs	31	na	ones	bzip	2256781	55917706	2361470	53556236	1882870	1788686	55917706	10781812	9883244	428739	10311983	11300716	sars-cov-2_pangenome_k32.r_0.2.S_greedytigs.k_31.d_na.M_ones.C_bzip
sars-cov-2_pangenome_k32	0.2	greedytigs	31	na	ones	xz	2256781	55917706	2361470	53556236	1882870	1788686	55917706	10781812	9883244	790760	10674004	11300716	sars-cov-2_pangenome_k32.r_0.2.S_greedytigs.k_31.d_na.M_ones.C_xz
sars-cov-2_pangenome_k32	0.2	greedytigs	31	na	runsapprox	bzip	2256781	55917706	2361470	53556236	1882870	1788686	55917706	10781812	9883244	428739	10311983	11300716	sars-cov-2_pangenome_k32.r_0.2.S_greedytigs.k_31.d_na.M_runsapprox.C_bzip
sars-cov-2_pangenome_k32	0.2	greedytigs	31	na	runsapprox	xz	2256781	55917706	2361470	53556236	1882870	1788686	55917706	10781812	9883244	790760	10674004	11300716	sars-cov-2_pangenome_k32.r_0.2.S_greedytigs.k_31.d_na.M_runsapprox.C_xz
sars-cov-2_pangenome_k32	0.3	greedytigs	31	na	default	bzip	3385172	73735365	3387465	70347900	2344930	2344930	73735365	13964660	12776620	513476	13290096	14697728	sars-cov-2_pangenome_k32.r_0.3.S_greedytigs.k_31.d_na.M_default.C_bzip
sars-cov-2_pangenome_k32	0.3	greedytigs	31	na	default	xz	3385172	73735365	3387465	70347900	2344930	2344930	73735365	13964660	12776620	934424	13711044	14697728	sars-cov-2_pangenome_k32.r_0.3.S_greedytigs.k_31.d_na.M_default.C_xz
sars-cov-2_pangenome_k32	0.3	greedytigs	31	na	ones	bzip	3385172	73735365	3592581	70142784	2520884	2344930	73735365	13964660	12776620	759683	13536303	14850800	sars-cov-2_pangenome_k32.r_0.3.S_greedytigs.k_31.d_na.M_ones.C_bzip
sars-cov-2_pangenome_k32	0.3	greedytigs	31	na	ones	xz	3385172	73735365	3592581	70142784	2520884	2344930	73735365	13964660	12776620	1338776	14115396	14850800	sars-cov-2_pangenome_k32.r_0.3.S_greedytigs.k_31.d_na.M_ones.C_xz
sars-cov-2_pangenome_k32	0.3	greedytigs	31	na	runsapprox	bzip	3385172	73735365	3592581	70142784	2520884	2344930	73735365	13964660	12776620	759683	13536303	14850800	sars-cov-2_pangenome_k32.r_0.3.S_greedytigs.k_31.d_na.M_runsapprox.C_bzip
sars-cov-2_pangenome_k32	0.3	greedytigs	31	na	runsapprox	xz	3385172	73735365	3592581	70142784	2520884	2344930	73735365	13964660	12776620	1338776	14115396	14850800	sars-cov-2_pangenome_k32.r_0.3.S_greedytigs.k_31.d_na.M_runsapprox.C_xz
sars-cov-2_pangenome_k32	0.4	greedytigs	31	na	default	bzip	4513562	84983152	4521712	80461440	2682048	2682048	84983152	15942448	14571620	737025	15308645	16972916	sars-cov-2_pangenome_k32.r_0.4.S_greedytigs.k_31.d_na.M_default.C_bzip
sars-cov-2_pangenome_k32	0.4	greedytigs	31	na	default	xz	4513562	84983152	4521712	80461440	2682048	2682048	84983152	15942448	14571620	1325024	15896644	16972916	sars-cov-2_pangenome_k32.r_0.4.S_greedytigs.k_31.d_na.M_default.C_xz
sars-cov-2_pangenome_k32	0.4	greedytigs	31	na	ones	bzip	4513562	84983152	4838582	80144570	2939559	2682048	84983152	15942448	14571620	1097555	15669175	17207804	sars-cov-2_pangenome_k32.r_0.4.S_greedytigs.k_31.d_na.M_ones.C_bzip
sars-cov-2_pangenome_k32	0.4	greedytigs	31	na	ones	xz	4513562	84983152	4838582	80144570	2939559	2682048	84983152	15942448	14571620	1847376	16418996	17207804	sars-cov-2_pangenome_k32.r_0.4.S_greedytigs.k_31.d_na.M_ones.C_xz
sars-cov-2_pangenome_k32	0.4	greedytigs	31	na	runsapprox	bzip	4513562	84983152	4838582	80144570	2939559	2682048	84983152	15942448	14571620	1097555	15669175	17207804	sars-cov-2_pangenome_k32.r_0.4.S_greedytigs.k_31.d_na.M_runsapprox.C_bzip
sars-cov-2_pangenome_k32	0.4	greedytigs	31	na	runsapprox	xz	4513562	84983152	4838582	80144570	2939559	2682048	84983152	15942448	14571620	1847376	16418996	17207804	sars-cov-2_pangenome_k32.r_0.4.S_greedytigs.k_31.d_na.M_runsapprox.C_xz
sars-cov-2_pangenome_k32	0.5	greedytigs	31	na	default	bzip	5641953	89721575	5664965	84056610	2801887	2801887	89721575	16761088	15324300	937569	16261869	18053568	sars-cov-2_pangenome_k32.r_0.5.S_greedytigs.k_31.d_na.M_default.C_bzip
sars-cov-2_pangenome_k32	0.5	greedytigs	31	na	default	xz	5641953	89721575	5664965	84056610	2801887	2801887	89721575	16761088	15324300	1663716	16988016	18053568	sars-cov-2_pangenome_k32.r_0.5.S_greedytigs.k_31.d_na.M_default.C_xz
sars-cov-2_pangenome_k32	0.5	greedytigs	31	na	ones	bzip	5641953	89721575	6084109	83637466	3124047	2801887	89721575	16761088	15324300	1390210	16714510	18359932	sars-cov-2_pangenome_k32.r_0.5.S_greedytigs.k_31.d_na.M_ones.C_bzip
sars-cov-2_pangenome_k32	0.5	greedytigs	31	na	ones	xz	5641953	89721575	6084109	83637466	3124047	2801887	89721575	16761088	15324300	2249540	17573840	18359932	sars-cov-2_pangenome_k32.r_0.5.S_greedytigs.k_31.d_na.M_ones.C_xz
sars-cov-2_pangenome_k32	0.5	greedytigs	31	na	runsapprox	bzip	5641953	89721575	6084109	83637466	3124047	2801887	89721575	16761088	15324300	1390210	16714510	18359932	sars-cov-2_pangenome_k32.r_0.5.S_greedytigs.k_31.d_na.M_runsapprox.C_bzip
sars-cov-2_pangenome_k32	0.5	greedytigs	31	na	runsapprox	xz	5641953	89721575	6084109	83637466	3124047	2801887	89721575	16761088	15324300	2249540	17573840	18359932	sars-cov-2_pangenome_k32.r_0.5.S_greedytigs.k_31.d_na.M_runsapprox.C_xz
sars-cov-2_pangenome_k32	0.6	greedytigs	31	na	default	bzip	6770344	88074884	6826214	81248670	2708289	2708289	88074884	16401380	14995844	1085133	16080977	17899056	sars-cov-2_pangenome_k32.r_0.6.S_greedytigs.k_31.d_na.M_default.C_bzip
sars-cov-2_pangenome_k32	0.6	greedytigs	31	na	default	xz	6770344	88074884	6826214	81248670	2708289	2708289	88074884	16401380	14995844	1893456	16889300	17899056	sars-cov-2_pangenome_k32.r_0.6.S_greedytigs.k_31.d_na.M_default.C_xz
sars-cov-2_pangenome_k32	0.6	greedytigs	31	na	ones	bzip	6770344	88074884	7321384	80753500	3064976	2708289	88074884	16401380	14995844	1594105	16589949	18258172	sars-cov-2_pangenome_k32.r_0.6.S_greedytigs.k_31.d_na.M_ones.C_bzip
sars-cov-2_pangenome_k32	0.6	greedytigs	31	na	ones	xz	6770344	88074884	7321384	80753500	3064976	2708289	88074884	16401380	14995844	2483532	17479376	18258172	sars-cov-2_pangenome_k32.r_0.6.S_greedytigs.k_31.d_na.M_ones.C_xz
sars-cov-2_pangenome_k32	0.6	greedytigs	31	na	runsapprox	bzip	6770344	88074884	7321384	80753500	3064976	2708289	88074884	16401380	14995844	1594105	16589949	18258172	sars-cov-2_pangenome_k32.r_0.6.S_greedytigs.k_31.d_na.M_runsapprox.C_bzip
sars-cov-2_pangenome_k32	0.6	greedytigs	31	na	runsapprox	xz	6770344	88074884	7321384	80753500	3064976	2708289	88074884	16401380	14995844	2483532	17479376	18258172	sars-cov-2_pangenome_k32.r_0.6.S_greedytigs.k_31.d_na.M_runsapprox.C_xz
sars-cov-2_pangenome_k32	0.7	greedytigs	31	na	default	bzip	7898734	80018518	8024788	71993730	2399791	2399791	80018518	14894488	13571376	1134670	14706046	16495656	sars-cov-2_pangenome_k32.r_0.7.S_greedytigs.k_31.d_na.M_default.C_bzip
sars-cov-2_pangenome_k32	0.7	greedytigs	31	na	default	xz	7898734	80018518	8024788	71993730	2399791	2399791	80018518	14894488	13571376	1949332	15520708	16495656	sars-cov-2_pangenome_k32.r_0.7.S_greedytigs.k_31.d_na.M_default.C_xz
sars-cov-2_pangenome_k32	0.7	greedytigs	31	na	ones	bzip	7898734	80018518	8550410	71468108	2750550	2399791	80018518	14894488	13571376	1650215	15221591	16879060	sars-cov-2_pangenome_k32.r_0.7.S_greedytigs.k_31.d_na.M_ones.C_bzip
sars-cov-2_pangenome_k32	0.7	greedytigs	31	na	ones	xz	7898734	80018518	8550410	71468108	2750550	2399791	80018518	14894488	13571376	2490364	16061740	16879060	sars-cov-2_pangenome_k32.r_0.7.S_greedytigs.k_31.d_na.M_ones.C_xz
sars-cov-2_pangenome_k32	0.7	greedytigs	31	na	runsapprox	bzip	7898734	80018518	8550410	71468108	2750550	2399791	80018518	14894488	13571376	1650215	15221591	16879060	sars-cov-2_pangenome_k32.r_0.7.S_greedytigs.k_31.d_na.M_runsapprox.C_bzip
sars-cov-2_pangenome_k32	0.7	greedytigs	31	na	runsapprox	xz	7898734	80018518	8550410	71468108	2750550	2399791	80018518	14894488	13571376	2490364	16061740	16879060	sars-cov-2_pangenome_k32.r_0.7.S_greedytigs.k_31.d_na.M_runsapprox.C_xz
sars-cov-2_pangenome_k32	0.8	greedytigs	31	na	default	bzip	9027125	65541859	9314809	56227050	1874235	1874235	65541859	12177668	11140792	1044160	12184952	13699800	sars-cov-2_pangenome_k32.r_0.8.S_greedytigs.k_31.d_na.M_default.C_bzip
sars-cov-2_pangenome_k32	0.8	greedytigs	31	na	default	xz	9027125	65541859	9314809	56227050	1874235	1874235	65541859	12177668	11140792	1761688	12902480	13699800	sars-cov-2_pangenome_k32.r_0.8.S_greedytigs.k_31.d_na.M_default.C_xz
sars-cov-2_pangenome_k32	0.8	greedytigs	31	na	ones	bzip	9027125	65541859	9804888	55736971	2168588	1874235	65541859	12177668	11140792	1500631	12641423	14060816	sars-cov-2_pangenome_k32.r_0.8.S_greedytigs.k_31.d_na.M_ones.C_bzip
sars-cov-2_pangenome_k32	0.8	greedytigs	31	na	ones	xz	9027125	65541859	9804888	55736971	2168588	1874235	65541859	12177668	11140792	2204880	13345672	14060816	sars-cov-2_pangenome_k32.r_0.8.S_greedytigs.k_31.d_na.M_ones.C_xz
sars-cov-2_pangenome_k32	0.8	greedytigs	31	na	runsapprox	bzip	9027125	65541859	9804888	55736971	2168588	1874235	65541859	12177668	11140792	1500631	12641423	14060816	sars-cov-2_pangenome_k32.r_0.8.S_greedytigs.k_31.d_na.M_runsapprox.C_bzip
sars-cov-2_pangenome_k32	0.8	greedytigs	31	na	runsapprox	xz	9027125	65541859	9804888	55736971	2168588	1874235	65541859	12177668	11140792	2204880	13345672	14060816	sars-cov-2_pangenome_k32.r_0.8.S_greedytigs.k_31.d_na.M_runsapprox.C_xz
sars-cov-2_pangenome_k32	0.9	greedytigs	31	na	default	bzip	10155516	44679605	10949255	33730350	1124345	1124345	44679605	8139696	7502584	762167	8264751	9345900	sars-cov-2_pangenome_k32.r_0.9.S_greedytigs.k_31.d_na.M_default.C_bzip
sars-cov-2_pangenome_k32	0.9	greedytigs	31	na	default	xz	10155516	44679605	10949255	33730350	1124345	1124345	44679605	8139696	7502584	1247028	8749612	9345900	sars-cov-2_pangenome_k32.r_0.9.S_greedytigs.k_31.d_na.M_default.C_xz
sars-cov-2_pangenome_k32	0.9	greedytigs	31	na	ones	bzip	10155516	44679605	11311704	33367901	1309398	1124345	44679605	8139696	7502584	1074412	8576996	9604752	sars-cov-2_pangenome_k32.r_0.9.S_greedytigs.k_31.d_na.M_ones.C_bzip
sars-cov-2_pangenome_k32	0.9	greedytigs	31	na	ones	xz	10155516	44679605	11311704	33367901	1309398	1124345	44679605	8139696	7502584	1549572	9052156	9604752	sars-cov-2_pangenome_k32.r_0.9.S_greedytigs.k_31.d_na.M_ones.C_xz
sars-cov-2_pangenome_k32	0.9	greedytigs	31	na	runsapprox	bzip	10155516	44679605	11311704	33367901	1309398	1124345	44679605	8139696	7502584	1074412	8576996	9604752	sars-cov-2_pangenome_k32.r_0.9.S_greedytigs.k_31.d_na.M_runsapprox.C_bzip
sars-cov-2_pangenome_k32	0.9	greedytigs	31	na	runsapprox	xz	10155516	44679605	11311704	33367901	1309398	1124345	44679605	8139696	7502584	1549572	9052156	9604752	sars-cov-2_pangenome_k32.r_0.9.S_greedytigs.k_31.d_na.M_runsapprox.C_xz
sars-cov-2_pangenome_k32	1.0	greedytigs	31	na	default	bzip	11283907	17318567	14181947	3136620	104554	104554	17318567	2254556	2186700	119818	2306518	2449128	sars-cov-2_pangenome_k32.r_1.0.S_greedytigs.k_31.d_na.M_default.C_bzip
sars-cov-2_pangenome_k32	1.0	greedytigs	31	na	default	xz	11283907	17318567	14181947	3136620	104554	104554	17318567	2254556	2186700	248616	2435316	2449128	sars-cov-2_pangenome_k32.r_1.0.S_greedytigs.k_31.d_na.M_default.C_xz
sars-cov-2_pangenome_k32	1.0	greedytigs	31	na	ones	bzip	11283907	17318567	14266797	3051770	117110	104554	17318567	2254556	2186700	162164	2348864	2476220	sars-cov-2_pangenome_k32.r_1.0.S_greedytigs.k_31.d_na.M_ones.C_bzip
sars-cov-2_pangenome_k32	1.0	greedytigs	31	na	ones	xz	11283907	17318567	14266797	3051770	117110	104554	17318567	2254556	2186700	293468	2480168	2476220	sars-cov-2_pangenome_k32.r_1.0.S_greedytigs.k_31.d_na.M_ones.C_xz
sars-cov-2_pangenome_k32	1.0	greedytigs	31	na	runsapprox	bzip	11283907	17318567	14266797	3051770	117110	104554	17318567	2254556	2186700	162164	2348864	2476220	sars-cov-2_pangenome_k32.r_1.0.S_greedytigs.k_31.d_na.M_runsapprox.C_bzip
sars-cov-2_pangenome_k32	1.0	greedytigs	31	na	runsapprox	xz	11283907	17318567	14266797	3051770	117110	104554	17318567	2254556	2186700	293468	2480168	2476220	sars-cov-2_pangenome_k32.r_1.0.S_greedytigs.k_31.d_na.M_runsapprox.C_xz
sars-cov-2_pangenome_k32	0.000000001	matchtigs	31	na	default	bzip	1	31	1	30	1	1	31	96	96	41	137	96	sars-cov-2_pangenome_k32.r_0.000000001.S_matchtigs.k_31.d_na.M_default.C_bzip
sars-cov-2_pangenome_k32	0.000000001	matchtigs	31	na	default	xz	1	31	1	30	1	1	31	96	96	76	172	96	sars-cov-2_pangenome_k32.r_0.000000001.S_matchtigs.k_31.d_na.M_default.C_xz
sars-cov-2_pangenome_k32	0.000000001	matchtigs	31	na	ones	bzip	1	31	1	30	1	1	31	96	96	41	137	96	sars-cov-2_pangenome_k32.r_0.000000001.S_matchtigs.k_31.d_na.M_ones.C_bzip
sars-cov-2_pangenome_k32	0.000000001	matchtigs	31	na	ones	xz	1	31	1	30	1	1	31	96	96	76	172	96	sars-cov-2_pangenome_k32.r_0.000000001.S_matchtigs.k_31.d_na.M_ones.C_xz
sars-cov-2_pangenome_k32	0.000000001	matchtigs	31	na	runsapprox	bzip	1	31	1	30	1	1	31	96	96	41	137	96	sars-cov-2_pangenome_k32.r_0.000000001.S_matchtigs.k_31.d_na.M_runsapprox.C_bzip
sars-cov-2_pangenome_k32	0.000000001	matchtigs	31	na	runsapprox	xz	1	31	1	30	1	1	31	96	96	76	172	96	sars-cov-2_pangenome_k32.r_0.000000001.S_matchtigs.k_31.d_na.M_runsapprox.C_xz
sars-cov-2_pangenome_k32	0.0001	matchtigs	31	na	default	bzip	1128	34938	1128	33810	1127	1127	34938	9916	9512	47	9559	9992	sars-cov-2_pangenome_k32.r_0.0001.S_matchtigs.k_31.d_na.M_default.C_bzip
sars-cov-2_pangenome_k32	0.0001	matchtigs	31	na	default	xz	1128	34938	1128	33810	1127	1127	34938	9916	9512	152	9664	9992	sars-cov-2_pangenome_k32.r_0.0001.S_matchtigs.k_31.d_na.M_default.C_xz
sars-cov-2_pangenome_k32	0.0001	matchtigs	31	na	ones	bzip	1128	34938	1128	33810	1127	1127	34938	9916	9512	47	9559	9992	sars-cov-2_pangenome_k32.r_0.0001.S_matchtigs.k_31.d_na.M_ones.C_bzip
sars-cov-2_pangenome_k32	0.0001	matchtigs	31	na	ones	xz	1128	34938	1128	33810	1127	1127	34938	9916	9512	152	9664	9992	sars-cov-2_pangenome_k32.r_0.0001.S_matchtigs.k_31.d_na.M_ones.C_xz
sars-cov-2_pangenome_k32	0.0001	matchtigs	31	na	runsapprox	bzip	1128	34938	1128	33810	1127	1127	34938	9916	9512	47	9559	9992	sars-cov-2_pangenome_k32.r_0.0001.S_matchtigs.k_31.d_na.M_runsapprox.C_bzip
sars-cov-2_pangenome_k32	0.0001	matchtigs	31	na	runsapprox	xz	1128	34938	1128	33810	1127	1127	34938	9916	9512	152	9664	9992	sars-cov-2_pangenome_k32.r_0.0001.S_matchtigs.k_31.d_na.M_runsapprox.C_xz
sars-cov-2_pangenome_k32	0.001	matchtigs	31	na	default	bzip	11283	349443	11283	338160	11272	11272	349443	86832	80600	71	80671	89236	sars-cov-2_pangenome_k32.r_0.001.S_matchtigs.k_31.d_na.M_default.C_bzip
sars-cov-2_pangenome_k32	0.001	matchtigs	31	na	default	xz	11283	349443	11283	338160	11272	11272	349443	86832	80600	248	80848	89236	sars-cov-2_pangenome_k32.r_0.001.S_matchtigs.k_31.d_na.M_default.C_xz
sars-cov-2_pangenome_k32	0.001	matchtigs	31	na	ones	bzip	11283	349443	11286	338157	11275	11272	349443	86832	80600	85	80685	89244	sars-cov-2_pangenome_k32.r_0.001.S_matchtigs.k_31.d_na.M_ones.C_bzip
sars-cov-2_pangenome_k32	0.001	matchtigs	31	na	ones	xz	11283	349443	11286	338157	11275	11272	349443	86832	80600	268	80868	89244	sars-cov-2_pangenome_k32.r_0.001.S_matchtigs.k_31.d_na.M_ones.C_xz
sars-cov-2_pangenome_k32	0.001	matchtigs	31	na	runsapprox	bzip	11283	349443	11286	338157	11275	11272	349443	86832	80600	85	80685	89244	sars-cov-2_pangenome_k32.r_0.001.S_matchtigs.k_31.d_na.M_runsapprox.C_bzip
sars-cov-2_pangenome_k32	0.001	matchtigs	31	na	runsapprox	xz	11283	349443	11286	338157	11275	11272	349443	86832	80600	268	80868	89244	sars-cov-2_pangenome_k32.r_0.001.S_matchtigs.k_31.d_na.M_runsapprox.C_xz
sars-cov-2_pangenome_k32	0.01	matchtigs	31	na	default	bzip	112839	3463059	112839	3350220	111674	111674	3463059	748060	688216	2046	690262	761112	sars-cov-2_pangenome_k32.r_0.01.S_matchtigs.k_31.d_na.M_default.C_bzip
sars-cov-2_pangenome_k32	0.01	matchtigs	31	na	default	xz	112839	3463059	112839	3350220	111674	111674	3463059	748060	688216	4036	692252	761112	sars-cov-2_pangenome_k32.r_0.01.S_matchtigs.k_31.d_na.M_default.C_xz
sars-cov-2_pangenome_k32	0.01	matchtigs	31	na	ones	bzip	112839	3463059	113172	3349887	112004	111674	3463059	748060	688216	2758	690974	761592	sars-cov-2_pangenome_k32.r_0.01.S_matchtigs.k_31.d_na.M_ones.C_bzip
sars-cov-2_pangenome_k32	0.01	matchtigs	31	na	ones	xz	112839	3463059	113172	3349887	112004	111674	3463059	748060	688216	5656	693872	761592	sars-cov-2_pangenome_k32.r_0.01.S_matchtigs.k_31.d_na.M_ones.C_xz
sars-cov-2_pangenome_k32	0.01	matchtigs	31	na	runsapprox	bzip	112839	3463059	113172	3349887	112004	111674	3463059	748060	688216	2758	690974	761592	sars-cov-2_pangenome_k32.r_0.01.S_matchtigs.k_31.d_na.M_runsapprox.C_bzip
sars-cov-2_pangenome_k32	0.01	matchtigs	31	na	runsapprox	xz	112839	3463059	113172	3349887	112004	111674	3463059	748060	688216	5656	693872	761592	sars-cov-2_pangenome_k32.r_0.01.S_matchtigs.k_31.d_na.M_runsapprox.C_xz
sars-cov-2_pangenome_k32	0.05	matchtigs	31	na	default	bzip	564195	16594905	564195	16030710	534357	534357	16594905	3371076	3104412	34928	3139340	3446580	sars-cov-2_pangenome_k32.r_0.05.S_matchtigs.k_31.d_na.M_default.C_bzip
sars-cov-2_pangenome_k32	0.05	matchtigs	31	na	default	xz	564195	16594905	564195	16030710	534357	534357	16594905	3371076	3104412	63612	3168024	3446580	sars-cov-2_pangenome_k32.r_0.05.S_matchtigs.k_31.d_na.M_default.C_xz
sars-cov-2_pangenome_k32	0.05	matchtigs	31	na	ones	bzip	564195	16594905	572115	16022790	542097	534357	16594905	3371076	3104412	47992	3152404	3453684	sars-cov-2_pangenome_k32.r_0.05.S_matchtigs.k_31.d_na.M_ones.C_bzip
sars-cov-2_pangenome_k32	0.05	matchtigs	31	na	ones	xz	564195	16594905	572115	16022790	542097	534357	16594905	3371076	3104412	93124	3197536	3453684	sars-cov-2_pangenome_k32.r_0.05.S_matchtigs.k_31.d_na.M_ones.C_xz
sars-cov-2_pangenome_k32	0.05	matchtigs	31	na	runsapprox	bzip	564195	16594905	572115	16022790	542097	534357	16594905	3371076	3104412	47992	3152404	3453684	sars-cov-2_pangenome_k32.r_0.05.S_matchtigs.k_31.d_na.M_runsapprox.C_bzip
sars-cov-2_pangenome_k32	0.05	matchtigs	31	na	runsapprox	xz	564195	16594905	572115	16022790	542097	534357	16594905	3371076	3104412	93124	3197536	3453684	sars-cov-2_pangenome_k32.r_0.05.S_matchtigs.k_31.d_na.M_runsapprox.C_xz
sars-cov-2_pangenome_k32	0.1	matchtigs	31	na	default	bzip	1128390	31430310	1128390	30301920	1010064	1010064	31430310	6244992	5737488	104913	5842401	6421692	sars-cov-2_pangenome_k32.r_0.1.S_matchtigs.k_31.d_na.M_default.C_bzip
sars-cov-2_pangenome_k32	0.1	matchtigs	31	na	default	xz	1128390	31430310	1128390	30301920	1010064	1010064	31430310	6244992	5737488	194088	5931576	6421692	sars-cov-2_pangenome_k32.r_0.1.S_matchtigs.k_31.d_na.M_default.C_xz
sars-cov-2_pangenome_k32	0.1	matchtigs	31	na	ones	bzip	1128390	31430310	1157485	30272825	1037685	1010064	31430310	6244992	5737488	148129	5885617	6443528	sars-cov-2_pangenome_k32.r_0.1.S_matchtigs.k_31.d_na.M_ones.C_bzip
sars-cov-2_pangenome_k32	0.1	matchtigs	31	na	ones	xz	1128390	31430310	1157485	30272825	1037685	1010064	31430310	6244992	5737488	284252	6021740	6443528	sars-cov-2_pangenome_k32.r_0.1.S_matchtigs.k_31.d_na.M_ones.C_xz
sars-cov-2_pangenome_k32	0.1	matchtigs	31	na	runsapprox	bzip	1128390	31430310	1157485	30272825	1037685	1010064	31430310	6244992	5737488	148129	5885617	6443528	sars-cov-2_pangenome_k32.r_0.1.S_matchtigs.k_31.d_na.M_runsapprox.C_bzip
sars-cov-2_pangenome_k32	0.1	matchtigs	31	na	runsapprox	xz	1128390	31430310	1157485	30272825	1037685	1010064	31430310	6244992	5737488	284252	6021740	6443528	sars-cov-2_pangenome_k32.r_0.1.S_matchtigs.k_31.d_na.M_runsapprox.C_xz
sars-cov-2_pangenome_k32	0.2	matchtigs	31	na	default	bzip	2256781	55925071	2256811	53668260	1788942	1788942	55925071	10782168	9882328	292207	10174535	11219348	sars-cov-2_pangenome_k32.r_0.2.S_matchtigs.k_31.d_na.M_default.C_bzip
sars-cov-2_pangenome_k32	0.2	matchtigs	31	na	default	xz	2256781	55925071	2256811	53668260	1788942	1788942	55925071	10782168	9882328	540816	10423144	11219348	sars-cov-2_pangenome_k32.r_0.2.S_matchtigs.k_31.d_na.M_default.C_xz
sars-cov-2_pangenome_k32	0.2	matchtigs	31	na	ones	bzip	2256781	55925071	2361568	53563503	1883402	1788942	55925071	10782168	9882328	428696	10311024	11300232	sars-cov-2_pangenome_k32.r_0.2.S_matchtigs.k_31.d_na.M_ones.C_bzip
sars-cov-2_pangenome_k32	0.2	matchtigs	31	na	ones	xz	2256781	55925071	2361568	53563503	1883402	1788942	55925071	10782168	9882328	790200	10672528	11300232	sars-cov-2_pangenome_k32.r_0.2.S_matchtigs.k_31.d_na.M_ones.C_xz
sars-cov-2_pangenome_k32	0.2	matchtigs	31	na	runsapprox	bzip	2256781	55925071	2361568	53563503	1883402	1788942	55925071	10782168	9882328	428696	10311024	11300232	sars-cov-2_pangenome_k32.r_0.2.S_matchtigs.k_31.d_na.M_runsapprox.C_bzip
sars-cov-2_pangenome_k32	0.2	matchtigs	31	na	runsapprox	xz	2256781	55925071	2361568	53563503	1883402	1788942	55925071	10782168	9882328	790200	10672528	11300232	sars-cov-2_pangenome_k32.r_0.2.S_matchtigs.k_31.d_na.M_runsapprox.C_xz
sars-cov-2_pangenome_k32	0.3	matchtigs	31	na	default	bzip	3385172	73767320	3385640	70381680	2346056	2346056	73767320	13972468	12775552	512649	13288201	14701676	sars-cov-2_pangenome_k32.r_0.3.S_matchtigs.k_31.d_na.M_default.C_bzip
sars-cov-2_pangenome_k32	0.3	matchtigs	31	na	default	xz	3385172	73767320	3385640	70381680	2346056	2346056	73767320	13972468	12775552	933148	13708700	14701676	sars-cov-2_pangenome_k32.r_0.3.S_matchtigs.k_31.d_na.M_default.C_xz
sars-cov-2_pangenome_k32	0.3	matchtigs	31	na	ones	bzip	3385172	73767320	3593312	70174008	2523508	2346056	73767320	13972468	12775552	762037	13537589	14862056	sars-cov-2_pangenome_k32.r_0.3.S_matchtigs.k_31.d_na.M_ones.C_bzip
sars-cov-2_pangenome_k32	0.3	matchtigs	31	na	ones	xz	3385172	73767320	3593312	70174008	2523508	2346056	73767320	13972468	12775552	1340344	14115896	14862056	sars-cov-2_pangenome_k32.r_0.3.S_matchtigs.k_31.d_na.M_ones.C_xz
sars-cov-2_pangenome_k32	0.3	matchtigs	31	na	runsapprox	bzip	3385172	73767320	3593312	70174008	2523508	2346056	73767320	13972468	12775552	762037	13537589	14862056	sars-cov-2_pangenome_k32.r_0.3.S_matchtigs.k_31.d_na.M_runsapprox.C_bzip
sars-cov-2_pangenome_k32	0.3	matchtigs	31	na	runsapprox	xz	3385172	73767320	3593312	70174008	2523508	2346056	73767320	13972468	12775552	1340344	14115896	14862056	sars-cov-2_pangenome_k32.r_0.3.S_matchtigs.k_31.d_na.M_runsapprox.C_xz
sars-cov-2_pangenome_k32	0.4	matchtigs	31	na	default	bzip	4513562	85054821	4516461	80538360	2684612	2684612	85054821	15949144	14578816	735815	15314631	16967532	sars-cov-2_pangenome_k32.r_0.4.S_matchtigs.k_31.d_na.M_default.C_bzip
sars-cov-2_pangenome_k32	0.4	matchtigs	31	na	default	xz	4513562	85054821	4516461	80538360	2684612	2684612	85054821	15949144	14578816	1322716	15901532	16967532	sars-cov-2_pangenome_k32.r_0.4.S_matchtigs.k_31.d_na.M_default.C_xz
sars-cov-2_pangenome_k32	0.4	matchtigs	31	na	ones	bzip	4513562	85054821	4837353	80217468	2943825	2684612	85054821	15949144	14578816	1099423	15678239	17211728	sars-cov-2_pangenome_k32.r_0.4.S_matchtigs.k_31.d_na.M_ones.C_bzip
sars-cov-2_pangenome_k32	0.4	matchtigs	31	na	ones	xz	4513562	85054821	4837353	80217468	2943825	2684612	85054821	15949144	14578816	1850768	16429584	17211728	sars-cov-2_pangenome_k32.r_0.4.S_matchtigs.k_31.d_na.M_ones.C_xz
sars-cov-2_pangenome_k32	0.4	matchtigs	31	na	runsapprox	bzip	4513562	85054821	4837353	80217468	2943825	2684612	85054821	15949144	14578816	1099423	15678239	17211728	sars-cov-2_pangenome_k32.r_0.4.S_matchtigs.k_31.d_na.M_runsapprox.C_bzip
sars-cov-2_pangenome_k32	0.4	matchtigs	31	na	runsapprox	xz	4513562	85054821	4837353	80217468	2943825	2684612	85054821	15949144	14578816	1850768	16429584	17211728	sars-cov-2_pangenome_k32.r_0.4.S_matchtigs.k_31.d_na.M_runsapprox.C_xz
sars-cov-2_pangenome_k32	0.5	matchtigs	31	na	default	bzip	5641953	89832424	5653414	84179010	2805967	2805967	89832424	16771396	15219308	935939	16155247	18064736	sars-cov-2_pangenome_k32.r_0.5.S_matchtigs.k_31.d_na.M_default.C_bzip
sars-cov-2_pangenome_k32	0.5	matchtigs	31	na	default	xz	5641953	89832424	5653414	84179010	2805967	2805967	89832424	16771396	15219308	1661228	16880536	18064736	sars-cov-2_pangenome_k32.r_0.5.S_matchtigs.k_31.d_na.M_default.C_xz
sars-cov-2_pangenome_k32	0.5	matchtigs	31	na	ones	bzip	5641953	89832424	6077433	83754991	3129162	2805967	89832424	16771396	15219308	1392886	16612194	18373212	sars-cov-2_pangenome_k32.r_0.5.S_matchtigs.k_31.d_na.M_ones.C_bzip
sars-cov-2_pangenome_k32	0.5	matchtigs	31	na	ones	xz	5641953	89832424	6077433	83754991	3129162	2805967	89832424	16771396	15219308	2251288	17470596	18373212	sars-cov-2_pangenome_k32.r_0.5.S_matchtigs.k_31.d_na.M_ones.C_xz
sars-cov-2_pangenome_k32	0.5	matchtigs	31	na	runsapprox	bzip	5641953	89832424	6077433	83754991	3129162	2805967	89832424	16771396	15219308	1392886	16612194	18373212	sars-cov-2_pangenome_k32.r_0.5.S_matchtigs.k_31.d_na.M_runsapprox.C_bzip
sars-cov-2_pangenome_k32	0.5	matchtigs	31	na	runsapprox	xz	5641953	89832424	6077433	83754991	3129162	2805967	89832424	16771396	15219308	2251288	17470596	18373212	sars-cov-2_pangenome_k32.r_0.5.S_matchtigs.k_31.d_na.M_runsapprox.C_xz
sars-cov-2_pangenome_k32	0.9	matchtigs	31	na	default	bzip	10155516	44538176	10702736	33835440	1127848	1127848	44538176	8136732	7503032	757960	8260992	9333852	sars-cov-2_pangenome_k32.r_0.9.S_matchtigs.k_31.d_na.M_default.C_bzip
sars-cov-2_pangenome_k32	0.9	matchtigs	31	na	default	xz	10155516	44538176	10702736	33835440	1127848	1127848	44538176	8136732	7503032	1242992	8746024	9333852	sars-cov-2_pangenome_k32.r_0.9.S_matchtigs.k_31.d_na.M_default.C_xz
sars-cov-2_pangenome_k32	0.9	matchtigs	31	na	ones	bzip	10155516	44538176	11058986	33479190	1310389	1127848	44538176	8136732	7503032	1068189	8571221	9591204	sars-cov-2_pangenome_k32.r_0.9.S_matchtigs.k_31.d_na.M_ones.C_bzip
sars-cov-2_pangenome_k32	0.9	matchtigs	31	na	ones	xz	10155516	44538176	11058986	33479190	1310389	1127848	44538176	8136732	7503032	1543656	9046688	9591204	sars-cov-2_pangenome_k32.r_0.9.S_matchtigs.k_31.d_na.M_ones.C_xz
sars-cov-2_pangenome_k32	0.9	matchtigs	31	na	runsapprox	bzip	10155516	44538176	11058986	33479190	1310389	1127848	44538176	8136732	7503032	1068189	8571221	9591204	sars-cov-2_pangenome_k32.r_0.9.S_matchtigs.k_31.d_na.M_runsapprox.C_bzip
sars-cov-2_pangenome_k32	0.9	matchtigs	31	na	runsapprox	xz	10155516	44538176	11058986	33479190	1310389	1127848	44538176	8136732	7503032	1543656	9046688	9591204	sars-cov-2_pangenome_k32.r_0.9.S_matchtigs.k_31.d_na.M_runsapprox.C_xz
sars-cov-2_pangenome_k32	1.0	matchtigs	31	na	default	bzip	11283907	16526388	12904938	3621450	120715	120715	16526388	2270928	2197216	132795	2330011	2482124	sars-cov-2_pangenome_k32.r_1.0.S_matchtigs.k_31.d_na.M_default.C_bzip
sars-cov-2_pangenome_k32	1.0	matchtigs	31	na	default	xz	11283907	16526388	12904938	3621450	120715	120715	16526388	2270928	2197216	267432	2464648	2482124	sars-cov-2_pangenome_k32.r_1.0.S_matchtigs.k_31.d_na.M_default.C_xz
sars-cov-2_pangenome_k32	1.0	matchtigs	31	na	ones	bzip	11283907	16526388	12992517	3533871	130226	120715	16526388	2270928	2197216	176181	2373397	2508668	sars-cov-2_pangenome_k32.r_1.0.S_matchtigs.k_31.d_na.M_ones.C_bzip
sars-cov-2_pangenome_k32	1.0	matchtigs	31	na	ones	xz	11283907	16526388	12992517	3533871	130226	120715	16526388	2270928	2197216	313008	2510224	2508668	sars-cov-2_pangenome_k32.r_1.0.S_matchtigs.k_31.d_na.M_ones.C_xz
sars-cov-2_pangenome_k32	1.0	matchtigs	31	na	runsapprox	bzip	11283907	16526388	12992517	3533871	130226	120715	16526388	2270928	2197216	176181	2373397	2508668	sars-cov-2_pangenome_k32.r_1.0.S_matchtigs.k_31.d_na.M_runsapprox.C_bzip
sars-cov-2_pangenome_k32	1.0	matchtigs	31	na	runsapprox	xz	11283907	16526388	12992517	3533871	130226	120715	16526388	2270928	2197216	313008	2510224	2508668	sars-cov-2_pangenome_k32.r_1.0.S_matchtigs.k_31.d_na.M_runsapprox.C_xz
sars-cov-2_pangenome_k32	0.000000001	prophasm	31	na	default	bzip	1	31	1	30	1	1	31	96	96	41	137	96	sars-cov-2_pangenome_k32.r_0.000000001.S_prophasm.k_31.d_na.M_default.C_bzip
sars-cov-2_pangenome_k32	0.000000001	prophasm	31	na	default	xz	1	31	1	30	1	1	31	96	96	76	172	96	sars-cov-2_pangenome_k32.r_0.000000001.S_prophasm.k_31.d_na.M_default.C_xz
sars-cov-2_pangenome_k32	0.000000001	prophasm	31	na	ones	bzip	1	31	1	30	1	1	31	96	96	41	137	96	sars-cov-2_pangenome_k32.r_0.000000001.S_prophasm.k_31.d_na.M_ones.C_bzip
sars-cov-2_pangenome_k32	0.000000001	prophasm	31	na	ones	xz	1	31	1	30	1	1	31	96	96	76	172	96	sars-cov-2_pangenome_k32.r_0.000000001.S_prophasm.k_31.d_na.M_ones.C_xz
sars-cov-2_pangenome_k32	0.000000001	prophasm	31	na	runsapprox	bzip	1	31	1	30	1	1	31	96	96	41	137	96	sars-cov-2_pangenome_k32.r_0.000000001.S_prophasm.k_31.d_na.M_runsapprox.C_bzip
sars-cov-2_pangenome_k32	0.000000001	prophasm	31	na	runsapprox	xz	1	31	1	30	1	1	31	96	96	76	172	96	sars-cov-2_pangenome_k32.r_0.000000001.S_prophasm.k_31.d_na.M_runsapprox.C_xz
sars-cov-2_pangenome_k32	0.0001	prophasm	31	na	default	bzip	1128	34938	1128	33810	1127	1127	34938	10580	9772	47	9819	10816	sars-cov-2_pangenome_k32.r_0.0001.S_prophasm.k_31.d_na.M_default.C_bzip
sars-cov-2_pangenome_k32	0.0001	prophasm	31	na	default	xz	1128	34938	1128	33810	1127	1127	34938	10580	9772	148	9920	10816	sars-cov-2_pangenome_k32.r_0.0001.S_prophasm.k_31.d_na.M_default.C_xz
sars-cov-2_pangenome_k32	0.0001	prophasm	31	na	ones	bzip	1128	34938	1128	33810	1127	1127	34938	10580	9772	47	9819	10816	sars-cov-2_pangenome_k32.r_0.0001.S_prophasm.k_31.d_na.M_ones.C_bzip
sars-cov-2_pangenome_k32	0.0001	prophasm	31	na	ones	xz	1128	34938	1128	33810	1127	1127	34938	10580	9772	148	9920	10816	sars-cov-2_pangenome_k32.r_0.0001.S_prophasm.k_31.d_na.M_ones.C_xz
sars-cov-2_pangenome_k32	0.0001	prophasm	31	na	runsapprox	bzip	1128	34938	1128	33810	1127	1127	34938	10580	9772	47	9819	10816	sars-cov-2_pangenome_k32.r_0.0001.S_prophasm.k_31.d_na.M_runsapprox.C_bzip
sars-cov-2_pangenome_k32	0.0001	prophasm	31	na	runsapprox	xz	1128	34938	1128	33810	1127	1127	34938	10580	9772	148	9920	10816	sars-cov-2_pangenome_k32.r_0.0001.S_prophasm.k_31.d_na.M_runsapprox.C_xz
sars-cov-2_pangenome_k32	0.001	prophasm	31	na	default	bzip	11283	349443	11283	338160	11272	11272	349443	89080	81640	69	81709	91196	sars-cov-2_pangenome_k32.r_0.001.S_prophasm.k_31.d_na.M_default.C_bzip
sars-cov-2_pangenome_k32	0.001	prophasm	31	na	default	xz	11283	349443	11283	338160	11272	11272	349443	89080	81640	240	81880	91196	sars-cov-2_pangenome_k32.r_0.001.S_prophasm.k_31.d_na.M_default.C_xz
sars-cov-2_pangenome_k32	0.001	prophasm	31	na	ones	bzip	11283	349443	11287	338156	11276	11272	349443	89080	81640	86	81726	91204	sars-cov-2_pangenome_k32.r_0.001.S_prophasm.k_31.d_na.M_ones.C_bzip
sars-cov-2_pangenome_k32	0.001	prophasm	31	na	ones	xz	11283	349443	11287	338156	11276	11272	349443	89080	81640	268	81908	91204	sars-cov-2_pangenome_k32.r_0.001.S_prophasm.k_31.d_na.M_ones.C_xz
sars-cov-2_pangenome_k32	0.001	prophasm	31	na	runsapprox	bzip	11283	349443	11287	338156	11276	11272	349443	89080	81640	86	81726	91204	sars-cov-2_pangenome_k32.r_0.001.S_prophasm.k_31.d_na.M_runsapprox.C_bzip
sars-cov-2_pangenome_k32	0.001	prophasm	31	na	runsapprox	xz	11283	349443	11287	338156	11276	11272	349443	89080	81640	268	81908	91204	sars-cov-2_pangenome_k32.r_0.001.S_prophasm.k_31.d_na.M_runsapprox.C_xz
sars-cov-2_pangenome_k32	0.01	prophasm	31	na	default	bzip	112839	3463059	112839	3350220	111674	111674	3463059	767356	706688	2028	708716	780040	sars-cov-2_pangenome_k32.r_0.01.S_prophasm.k_31.d_na.M_default.C_bzip
sars-cov-2_pangenome_k32	0.01	prophasm	31	na	default	xz	112839	3463059	112839	3350220	111674	111674	3463059	767356	706688	3972	710660	780040	sars-cov-2_pangenome_k32.r_0.01.S_prophasm.k_31.d_na.M_default.C_xz
sars-cov-2_pangenome_k32	0.01	prophasm	31	na	ones	bzip	112839	3463059	113164	3349895	111997	111674	3463059	767356	706688	2733	709421	780232	sars-cov-2_pangenome_k32.r_0.01.S_prophasm.k_31.d_na.M_ones.C_bzip
sars-cov-2_pangenome_k32	0.01	prophasm	31	na	ones	xz	112839	3463059	113164	3349895	111997	111674	3463059	767356	706688	5616	712304	780232	sars-cov-2_pangenome_k32.r_0.01.S_prophasm.k_31.d_na.M_ones.C_xz
sars-cov-2_pangenome_k32	0.01	prophasm	31	na	runsapprox	bzip	112839	3463059	113164	3349895	111997	111674	3463059	767356	706688	2733	709421	780232	sars-cov-2_pangenome_k32.r_0.01.S_prophasm.k_31.d_na.M_runsapprox.C_bzip
sars-cov-2_pangenome_k32	0.01	prophasm	31	na	runsapprox	xz	112839	3463059	113164	3349895	111997	111674	3463059	767356	706688	5616	712304	780232	sars-cov-2_pangenome_k32.r_0.01.S_prophasm.k_31.d_na.M_runsapprox.C_xz
sars-cov-2_pangenome_k32	0.05	prophasm	31	na	default	bzip	564195	16594905	564195	16030710	534357	534357	16594905	3425640	3180792	32847	3213639	3495556	sars-cov-2_pangenome_k32.r_0.05.S_prophasm.k_31.d_na.M_default.C_bzip
sars-cov-2_pangenome_k32	0.05	prophasm	31	na	default	xz	564195	16594905	564195	16030710	534357	534357	16594905	3425640	3180792	60152	3240944	3495556	sars-cov-2_pangenome_k32.r_0.05.S_prophasm.k_31.d_na.M_default.C_xz
sars-cov-2_pangenome_k32	0.05	prophasm	31	na	ones	bzip	564195	16594905	572081	16022824	542063	534357	16594905	3425640	3180792	46015	3226807	3503064	sars-cov-2_pangenome_k32.r_0.05.S_prophasm.k_31.d_na.M_ones.C_bzip
sars-cov-2_pangenome_k32	0.05	prophasm	31	na	ones	xz	564195	16594905	572081	16022824	542063	534357	16594905	3425640	3180792	89888	3270680	3503064	sars-cov-2_pangenome_k32.r_0.05.S_prophasm.k_31.d_na.M_ones.C_xz
sars-cov-2_pangenome_k32	0.05	prophasm	31	na	runsapprox	bzip	564195	16594905	572081	16022824	542063	534357	16594905	3425640	3180792	46015	3226807	3503064	sars-cov-2_pangenome_k32.r_0.05.S_prophasm.k_31.d_na.M_runsapprox.C_bzip
sars-cov-2_pangenome_k32	0.05	prophasm	31	na	runsapprox	xz	564195	16594905	572081	16022824	542063	534357	16594905	3425640	3180792	89888	3270680	3503064	sars-cov-2_pangenome_k32.r_0.05.S_prophasm.k_31.d_na.M_runsapprox.C_xz
sars-cov-2_pangenome_k32	0.1	prophasm	31	na	default	bzip	1128390	31430310	1128390	30301920	1010064	1010064	31430310	6298108	5844044	97431	5941475	6462840	sars-cov-2_pangenome_k32.r_0.1.S_prophasm.k_31.d_na.M_default.C_bzip
sars-cov-2_pangenome_k32	0.1	prophasm	31	na	default	xz	1128390	31430310	1128390	30301920	1010064	1010064	31430310	6298108	5844044	179996	6024040	6462840	sars-cov-2_pangenome_k32.r_0.1.S_prophasm.k_31.d_na.M_default.C_xz
sars-cov-2_pangenome_k32	0.1	prophasm	31	na	ones	bzip	1128390	31430310	1158453	30271857	1038569	1010064	31430310	6298108	5844044	142296	5986340	6490532	sars-cov-2_pangenome_k32.r_0.1.S_prophasm.k_31.d_na.M_ones.C_bzip
sars-cov-2_pangenome_k32	0.1	prophasm	31	na	ones	xz	1128390	31430310	1158453	30271857	1038569	1010064	31430310	6298108	5844044	274868	6118912	6490532	sars-cov-2_pangenome_k32.r_0.1.S_prophasm.k_31.d_na.M_ones.C_xz
sars-cov-2_pangenome_k32	0.1	prophasm	31	na	runsapprox	bzip	1128390	31430310	1158453	30271857	1038569	1010064	31430310	6298108	5844044	142296	5986340	6490532	sars-cov-2_pangenome_k32.r_0.1.S_prophasm.k_31.d_na.M_runsapprox.C_bzip
sars-cov-2_pangenome_k32	0.1	prophasm	31	na	runsapprox	xz	1128390	31430310	1158453	30271857	1038569	1010064	31430310	6298108	5844044	274868	6118912	6490532	sars-cov-2_pangenome_k32.r_0.1.S_prophasm.k_31.d_na.M_runsapprox.C_xz
sars-cov-2_pangenome_k32	0.2	prophasm	31	na	default	bzip	2256781	55925791	2256781	53669010	1788967	1788967	55925791	10855104	10022036	271818	10293854	11264052	sars-cov-2_pangenome_k32.r_0.2.S_prophasm.k_31.d_na.M_default.C_bzip
sars-cov-2_pangenome_k32	0.2	prophasm	31	na	default	xz	2256781	55925791	2256781	53669010	1788967	1788967	55925791	10855104	10022036	498548	10520584	11264052	sars-cov-2_pangenome_k32.r_0.2.S_prophasm.k_31.d_na.M_default.C_xz
sars-cov-2_pangenome_k32	0.2	prophasm	31	na	ones	bzip	2256781	55925791	2363853	53561938	1885558	1788967	55925791	10855104	10022036	412700	10434736	11354484	sars-cov-2_pangenome_k32.r_0.2.S_prophasm.k_31.d_na.M_ones.C_bzip
sars-cov-2_pangenome_k32	0.2	prophasm	31	na	ones	xz	2256781	55925791	2363853	53561938	1885558	1788967	55925791	10855104	10022036	763512	10785548	11354484	sars-cov-2_pangenome_k32.r_0.2.S_prophasm.k_31.d_na.M_ones.C_xz
sars-cov-2_pangenome_k32	0.2	prophasm	31	na	runsapprox	bzip	2256781	55925791	2363853	53561938	1885558	1788967	55925791	10855104	10022036	412700	10434736	11354484	sars-cov-2_pangenome_k32.r_0.2.S_prophasm.k_31.d_na.M_runsapprox.C_bzip
sars-cov-2_pangenome_k32	0.2	prophasm	31	na	runsapprox	xz	2256781	55925791	2363853	53561938	1885558	1788967	55925791	10855104	10022036	763512	10785548	11354484	sars-cov-2_pangenome_k32.r_0.2.S_prophasm.k_31.d_na.M_runsapprox.C_xz
sars-cov-2_pangenome_k32	0.3	prophasm	31	na	default	bzip	3385172	73777532	3385172	70392360	2346412	2346412	73777532	14049324	12904024	473663	13377687	14742364	sars-cov-2_pangenome_k32.r_0.3.S_prophasm.k_31.d_na.M_default.C_bzip
sars-cov-2_pangenome_k32	0.3	prophasm	31	na	default	xz	3385172	73777532	3385172	70392360	2346412	2346412	73777532	14049324	12904024	857180	13761204	14742364	sars-cov-2_pangenome_k32.r_0.3.S_prophasm.k_31.d_na.M_default.C_xz
sars-cov-2_pangenome_k32	0.3	prophasm	31	na	ones	bzip	3385172	73777532	3598771	70178761	2528734	2346412	73777532	14049324	12904024	733785	13637809	14914148	sars-cov-2_pangenome_k32.r_0.3.S_prophasm.k_31.d_na.M_ones.C_bzip
sars-cov-2_pangenome_k32	0.3	prophasm	31	na	ones	xz	3385172	73777532	3598771	70178761	2528734	2346412	73777532	14049324	12904024	1294856	14198880	14914148	sars-cov-2_pangenome_k32.r_0.3.S_prophasm.k_31.d_na.M_ones.C_xz
sars-cov-2_pangenome_k32	0.3	prophasm	31	na	runsapprox	bzip	3385172	73777532	3598771	70178761	2528734	2346412	73777532	14049324	12904024	733785	13637809	14914148	sars-cov-2_pangenome_k32.r_0.3.S_prophasm.k_31.d_na.M_runsapprox.C_bzip
sars-cov-2_pangenome_k32	0.3	prophasm	31	na	runsapprox	xz	3385172	73777532	3598771	70178761	2528734	2346412	73777532	14049324	12904024	1294856	14198880	14914148	sars-cov-2_pangenome_k32.r_0.3.S_prophasm.k_31.d_na.M_runsapprox.C_xz
sars-cov-2_pangenome_k32	0.4	prophasm	31	na	default	bzip	4513562	85109492	4513562	80595930	2686531	2686531	85109492	16041832	14676596	676100	15352696	17012236	sars-cov-2_pangenome_k32.r_0.4.S_prophasm.k_31.d_na.M_default.C_bzip
sars-cov-2_pangenome_k32	0.4	prophasm	31	na	default	xz	4513562	85109492	4513562	80595930	2686531	2686531	85109492	16041832	14676596	1207488	15884084	17012236	sars-cov-2_pangenome_k32.r_0.4.S_prophasm.k_31.d_na.M_default.C_xz
sars-cov-2_pangenome_k32	0.4	prophasm	31	na	ones	bzip	4513562	85109492	4845114	80264378	2952794	2686531	85109492	16041832	14676596	1055095	15731691	17269104	sars-cov-2_pangenome_k32.r_0.4.S_prophasm.k_31.d_na.M_ones.C_bzip
sars-cov-2_pangenome_k32	0.4	prophasm	31	na	ones	xz	4513562	85109492	4845114	80264378	2952794	2686531	85109492	16041832	14676596	1780604	16457200	17269104	sars-cov-2_pangenome_k32.r_0.4.S_prophasm.k_31.d_na.M_ones.C_xz
sars-cov-2_pangenome_k32	0.4	prophasm	31	na	runsapprox	bzip	4513562	85109492	4845114	80264378	2952794	2686531	85109492	16041832	14676596	1055095	15731691	17269104	sars-cov-2_pangenome_k32.r_0.4.S_prophasm.k_31.d_na.M_runsapprox.C_bzip
sars-cov-2_pangenome_k32	0.4	prophasm	31	na	runsapprox	xz	4513562	85109492	4845114	80264378	2952794	2686531	85109492	16041832	14676596	1780604	16457200	17269104	sars-cov-2_pangenome_k32.r_0.4.S_prophasm.k_31.d_na.M_runsapprox.C_xz
sars-cov-2_pangenome_k32	0.5	prophasm	31	na	default	bzip	5641953	90015213	5641953	84373260	2812442	2812442	90015213	16840052	15409192	852247	16261439	18078588	sars-cov-2_pangenome_k32.r_0.5.S_prophasm.k_31.d_na.M_default.C_bzip
sars-cov-2_pangenome_k32	0.5	prophasm	31	na	default	xz	5641953	90015213	5641953	84373260	2812442	2812442	90015213	16840052	15409192	1500668	16909860	18078588	sars-cov-2_pangenome_k32.r_0.5.S_prophasm.k_31.d_na.M_default.C_xz
sars-cov-2_pangenome_k32	0.5	prophasm	31	na	ones	bzip	5641953	90015213	6088016	83927197	3146210	2812442	90015213	16840052	15409192	1333996	16743188	18404868	sars-cov-2_pangenome_k32.r_0.5.S_prophasm.k_31.d_na.M_ones.C_bzip
sars-cov-2_pangenome_k32	0.5	prophasm	31	na	ones	xz	5641953	90015213	6088016	83927197	3146210	2812442	90015213	16840052	15409192	2159608	17568800	18404868	sars-cov-2_pangenome_k32.r_0.5.S_prophasm.k_31.d_na.M_ones.C_xz
sars-cov-2_pangenome_k32	0.5	prophasm	31	na	runsapprox	bzip	5641953	90015213	6088016	83927197	3146210	2812442	90015213	16840052	15409192	1333996	16743188	18404868	sars-cov-2_pangenome_k32.r_0.5.S_prophasm.k_31.d_na.M_runsapprox.C_bzip
sars-cov-2_pangenome_k32	0.5	prophasm	31	na	runsapprox	xz	5641953	90015213	6088016	83927197	3146210	2812442	90015213	16840052	15409192	2159608	17568800	18404868	sars-cov-2_pangenome_k32.r_0.5.S_prophasm.k_31.d_na.M_runsapprox.C_xz
sars-cov-2_pangenome_k32	0.6	prophasm	31	na	default	bzip	6770344	88656604	6770344	81886260	2729542	2729542	88656604	16491920	15096292	971890	16068182	17931516	sars-cov-2_pangenome_k32.r_0.6.S_prophasm.k_31.d_na.M_default.C_bzip
sars-cov-2_pangenome_k32	0.6	prophasm	31	na	default	xz	6770344	88656604	6770344	81886260	2729542	2729542	88656604	16491920	15096292	1692316	16788608	17931516	sars-cov-2_pangenome_k32.r_0.6.S_prophasm.k_31.d_na.M_default.C_xz
sars-cov-2_pangenome_k32	0.6	prophasm	31	na	ones	bzip	6770344	88656604	7313710	81342894	3103689	2729542	88656604	16491920	15096292	1524953	16621245	18319812	sars-cov-2_pangenome_k32.r_0.6.S_prophasm.k_31.d_na.M_ones.C_bzip
sars-cov-2_pangenome_k32	0.6	prophasm	31	na	ones	xz	6770344	88656604	7313710	81342894	3103689	2729542	88656604	16491920	15096292	2382536	17478828	18319812	sars-cov-2_pangenome_k32.r_0.6.S_prophasm.k_31.d_na.M_ones.C_xz
sars-cov-2_pangenome_k32	0.6	prophasm	31	na	runsapprox	bzip	6770344	88656604	7313710	81342894	3103689	2729542	88656604	16491920	15096292	1524953	16621245	18319812	sars-cov-2_pangenome_k32.r_0.6.S_prophasm.k_31.d_na.M_runsapprox.C_bzip
sars-cov-2_pangenome_k32	0.6	prophasm	31	na	runsapprox	xz	6770344	88656604	7313710	81342894	3103689	2729542	88656604	16491920	15096292	2382536	17478828	18319812	sars-cov-2_pangenome_k32.r_0.6.S_prophasm.k_31.d_na.M_runsapprox.C_xz
sars-cov-2_pangenome_k32	0.7	prophasm	31	na	default	bzip	7898734	81062554	7898734	73163820	2438794	2438794	81062554	14966608	13722516	1004431	14726947	16526832	sars-cov-2_pangenome_k32.r_0.7.S_prophasm.k_31.d_na.M_default.C_bzip
sars-cov-2_pangenome_k32	0.7	prophasm	31	na	default	xz	7898734	81062554	7898734	73163820	2438794	2438794	81062554	14966608	13722516	1740528	15463044	16526832	sars-cov-2_pangenome_k32.r_0.7.S_prophasm.k_31.d_na.M_default.C_xz
sars-cov-2_pangenome_k32	0.7	prophasm	31	na	ones	bzip	7898734	81062554	8507271	72555283	2814466	2438794	81062554	14966608	13722516	1583138	15305654	16949240	sars-cov-2_pangenome_k32.r_0.7.S_prophasm.k_31.d_na.M_ones.C_bzip
sars-cov-2_pangenome_k32	0.7	prophasm	31	na	ones	xz	7898734	81062554	8507271	72555283	2814466	2438794	81062554	14966608	13722516	2402580	16125096	16949240	sars-cov-2_pangenome_k32.r_0.7.S_prophasm.k_31.d_na.M_ones.C_xz
sars-cov-2_pangenome_k32	0.7	prophasm	31	na	runsapprox	bzip	7898734	81062554	8507271	72555283	2814466	2438794	81062554	14966608	13722516	1583138	15305654	16949240	sars-cov-2_pangenome_k32.r_0.7.S_prophasm.k_31.d_na.M_runsapprox.C_bzip
sars-cov-2_pangenome_k32	0.7	prophasm	31	na	runsapprox	xz	7898734	81062554	8507271	72555283	2814466	2438794	81062554	14966608	13722516	2402580	16125096	16949240	sars-cov-2_pangenome_k32.r_0.7.S_prophasm.k_31.d_na.M_runsapprox.C_xz
sars-cov-2_pangenome_k32	0.8	prophasm	31	na	default	bzip	9027125	67315385	9027125	58288260	1942942	1942942	67315385	12314136	11307812	923173	12230985	13819844	sars-cov-2_pangenome_k32.r_0.8.S_prophasm.k_31.d_na.M_default.C_bzip
sars-cov-2_pangenome_k32	0.8	prophasm	31	na	default	xz	9027125	67315385	9027125	58288260	1942942	1942942	67315385	12314136	11307812	1594396	12902208	13819844	sars-cov-2_pangenome_k32.r_0.8.S_prophasm.k_31.d_na.M_default.C_xz
sars-cov-2_pangenome_k32	0.8	prophasm	31	na	ones	bzip	9027125	67315385	9651381	57664004	2272184	1942942	67315385	12314136	11307812	1466550	12774362	14225656	sars-cov-2_pangenome_k32.r_0.8.S_prophasm.k_31.d_na.M_ones.C_bzip
sars-cov-2_pangenome_k32	0.8	prophasm	31	na	ones	xz	9027125	67315385	9651381	57664004	2272184	1942942	67315385	12314136	11307812	2168644	13476456	14225656	sars-cov-2_pangenome_k32.r_0.8.S_prophasm.k_31.d_na.M_ones.C_xz
sars-cov-2_pangenome_k32	0.8	prophasm	31	na	runsapprox	bzip	9027125	67315385	9651381	57664004	2272184	1942942	67315385	12314136	11307812	1466550	12774362	14225656	sars-cov-2_pangenome_k32.r_0.8.S_prophasm.k_31.d_na.M_runsapprox.C_bzip
sars-cov-2_pangenome_k32	0.8	prophasm	31	na	runsapprox	xz	9027125	67315385	9651381	57664004	2272184	1942942	67315385	12314136	11307812	2168644	13476456	14225656	sars-cov-2_pangenome_k32.r_0.8.S_prophasm.k_31.d_na.M_runsapprox.C_xz
sars-cov-2_pangenome_k32	0.9	prophasm	31	na	default	bzip	10155516	47503026	10155516	37347510	1244917	1244917	47503026	8456888	7796448	699455	8495903	9675872	sars-cov-2_pangenome_k32.r_0.9.S_prophasm.k_31.d_na.M_default.C_bzip
sars-cov-2_pangenome_k32	0.9	prophasm	31	na	default	xz	10155516	47503026	10155516	37347510	1244917	1244917	47503026	8456888	7796448	1202256	8998704	9675872	sars-cov-2_pangenome_k32.r_0.9.S_prophasm.k_31.d_na.M_default.C_xz
sars-cov-2_pangenome_k32	0.9	prophasm	31	na	ones	bzip	10155516	47503026	10732659	36770367	1475950	1244917	47503026	8456888	7796448	1130844	8927292	9999284	sars-cov-2_pangenome_k32.r_0.9.S_prophasm.k_31.d_na.M_ones.C_bzip
sars-cov-2_pangenome_k32	0.9	prophasm	31	na	ones	xz	10155516	47503026	10732659	36770367	1475950	1244917	47503026	8456888	7796448	1634432	9430880	9999284	sars-cov-2_pangenome_k32.r_0.9.S_prophasm.k_31.d_na.M_ones.C_xz
sars-cov-2_pangenome_k32	0.9	prophasm	31	na	runsapprox	bzip	10155516	47503026	10732659	36770367	1475950	1244917	47503026	8456888	7796448	1130844	8927292	9999284	sars-cov-2_pangenome_k32.r_0.9.S_prophasm.k_31.d_na.M_runsapprox.C_bzip
sars-cov-2_pangenome_k32	0.9	prophasm	31	na	runsapprox	xz	10155516	47503026	10732659	36770367	1475950	1244917	47503026	8456888	7796448	1634432	9430880	9999284	sars-cov-2_pangenome_k32.r_0.9.S_prophasm.k_31.d_na.M_runsapprox.C_xz
sars-cov-2_pangenome_k32	1.0	prophasm	31	na	default	bzip	11283907	21558577	11283907	10274670	342489	342489	21558577	3005216	2850024	278828	3128852	3484344	sars-cov-2_pangenome_k32.r_1.0.S_prophasm.k_31.d_na.M_default.C_bzip
sars-cov-2_pangenome_k32	1.0	prophasm	31	na	default	xz	11283907	21558577	11283907	10274670	342489	342489	21558577	3005216	2850024	495848	3345872	3484344	sars-cov-2_pangenome_k32.r_1.0.S_prophasm.k_31.d_na.M_default.C_xz
sars-cov-2_pangenome_k32	1.0	prophasm	31	na	ones	bzip	11283907	21558577	11733799	9824778	422276	342489	21558577	3005216	2850024	471947	3321971	3643980	sars-cov-2_pangenome_k32.r_1.0.S_prophasm.k_31.d_na.M_ones.C_bzip
sars-cov-2_pangenome_k32	1.0	prophasm	31	na	ones	xz	11283907	21558577	11733799	9824778	422276	342489	21558577	3005216	2850024	689292	3539316	3643980	sars-cov-2_pangenome_k32.r_1.0.S_prophasm.k_31.d_na.M_ones.C_xz
sars-cov-2_pangenome_k32	1.0	prophasm	31	na	runsapprox	bzip	11283907	21558577	11733799	9824778	422276	342489	21558577	3005216	2850024	471947	3321971	3643980	sars-cov-2_pangenome_k32.r_1.0.S_prophasm.k_31.d_na.M_runsapprox.C_bzip
sars-cov-2_pangenome_k32	1.0	prophasm	31	na	runsapprox	xz	11283907	21558577	11733799	9824778	422276	342489	21558577	3005216	2850024	689292	3539316	3643980	sars-cov-2_pangenome_k32.r_1.0.S_prophasm.k_31.d_na.M_runsapprox.C_xz
spneumo_pangenome_k32	0.000000001	prophasm	9	na	default	bzip	1	9	1	8	1	1	9	76	76	41	117	76	spneumo_pangenome_k32.r_0.000000001.S_prophasm.k_9.d_na.M_default.C_bzip
spneumo_pangenome_k32	0.000000001	prophasm	9	na	default	xz	1	9	1	8	1	1	9	76	76	76	152	76	spneumo_pangenome_k32.r_0.000000001.S_prophasm.k_9.d_na.M_default.C_xz
spneumo_pangenome_k32	0.000000001	prophasm	9	na	ones	bzip	1	9	1	8	1	1	9	76	76	41	117	76	spneumo_pangenome_k32.r_0.000000001.S_prophasm.k_9.d_na.M_ones.C_bzip
spneumo_pangenome_k32	0.000000001	prophasm	9	na	ones	xz	1	9	1	8	1	1	9	76	76	76	152	76	spneumo_pangenome_k32.r_0.000000001.S_prophasm.k_9.d_na.M_ones.C_xz
spneumo_pangenome_k32	0.000000001	prophasm	9	na	runsapprox	bzip	1	9	1	8	1	1	9	76	76	41	117	76	spneumo_pangenome_k32.r_0.000000001.S_prophasm.k_9.d_na.M_runsapprox.C_bzip
spneumo_pangenome_k32	0.000000001	prophasm	9	na	runsapprox	xz	1	9	1	8	1	1	9	76	76	76	152	76	spneumo_pangenome_k32.r_0.000000001.S_prophasm.k_9.d_na.M_runsapprox.C_xz
spneumo_pangenome_k32	0.0001	prophasm	9	na	default	bzip	13	117	13	104	13	13	117	156	140	44	184	148	spneumo_pangenome_k32.r_0.0001.S_prophasm.k_9.d_na.M_default.C_bzip
spneumo_pangenome_k32	0.0001	prophasm	9	na	default	xz	13	117	13	104	13	13	117	156	140	80	220	148	spneumo_pangenome_k32.r_0.0001.S_prophasm.k_9.d_na.M_default.C_xz
spneumo_pangenome_k32	0.0001	prophasm	9	na	ones	bzip	13	117	13	104	13	13	117	156	140	44	184	148	spneumo_pangenome_k32.r_0.0001.S_prophasm.k_9.d_na.M_ones.C_bzip
spneumo_pangenome_k32	0.0001	prophasm	9	na	ones	xz	13	117	13	104	13	13	117	156	140	80	220	148	spneumo_pangenome_k32.r_0.0001.S_prophasm.k_9.d_na.M_ones.C_xz
spneumo_pangenome_k32	0.0001	prophasm	9	na	runsapprox	bzip	13	117	13	104	13	13	117	156	140	44	184	148	spneumo_pangenome_k32.r_0.0001.S_prophasm.k_9.d_na.M_runsapprox.C_bzip
spneumo_pangenome_k32	0.0001	prophasm	9	na	runsapprox	xz	13	117	13	104	13	13	117	156	140	80	220	148	spneumo_pangenome_k32.r_0.0001.S_prophasm.k_9.d_na.M_runsapprox.C_xz
spneumo_pangenome_k32	0.001	prophasm	9	na	default	bzip	130	1162	130	1032	129	129	1162	604	516	45	561	620	spneumo_pangenome_k32.r_0.001.S_prophasm.k_9.d_na.M_default.C_bzip
spneumo_pangenome_k32	0.001	prophasm	9	na	default	xz	130	1162	130	1032	129	129	1162	604	516	92	608	620	spneumo_pangenome_k32.r_0.001.S_prophasm.k_9.d_na.M_default.C_xz
spneumo_pangenome_k32	0.001	prophasm	9	na	ones	bzip	130	1162	134	1028	132	129	1162	604	516	58	574	620	spneumo_pangenome_k32.r_0.001.S_prophasm.k_9.d_na.M_ones.C_bzip
spneumo_pangenome_k32	0.001	prophasm	9	na	ones	xz	130	1162	134	1028	132	129	1162	604	516	104	620	620	spneumo_pangenome_k32.r_0.001.S_prophasm.k_9.d_na.M_ones.C_xz
spneumo_pangenome_k32	0.001	prophasm	9	na	runsapprox	bzip	130	1162	134	1028	132	129	1162	604	516	58	574	620	spneumo_pangenome_k32.r_0.001.S_prophasm.k_9.d_na.M_runsapprox.C_bzip
spneumo_pangenome_k32	0.001	prophasm	9	na	runsapprox	xz	130	1162	134	1028	132	129	1162	604	516	104	620	620	spneumo_pangenome_k32.r_0.001.S_prophasm.k_9.d_na.M_runsapprox.C_xz
spneumo_pangenome_k32	0.01	prophasm	9	na	default	bzip	1305	11353	1305	10048	1256	1256	11353	4188	3492	108	3600	4232	spneumo_pangenome_k32.r_0.01.S_prophasm.k_9.d_na.M_default.C_bzip
spneumo_pangenome_k32	0.01	prophasm	9	na	default	xz	1305	11353	1305	10048	1256	1256	11353	4188	3492	212	3704	4232	spneumo_pangenome_k32.r_0.01.S_prophasm.k_9.d_na.M_default.C_xz
spneumo_pangenome_k32	0.01	prophasm	9	na	ones	bzip	1305	11353	1372	9981	1320	1256	11353	4188	3492	228	3720	4268	spneumo_pangenome_k32.r_0.01.S_prophasm.k_9.d_na.M_ones.C_bzip
spneumo_pangenome_k32	0.01	prophasm	9	na	ones	xz	1305	11353	1372	9981	1320	1256	11353	4188	3492	364	3856	4268	spneumo_pangenome_k32.r_0.01.S_prophasm.k_9.d_na.M_ones.C_xz
spneumo_pangenome_k32	0.01	prophasm	9	na	runsapprox	bzip	1305	11353	1372	9981	1320	1256	11353	4188	3492	228	3720	4268	spneumo_pangenome_k32.r_0.01.S_prophasm.k_9.d_na.M_runsapprox.C_bzip
spneumo_pangenome_k32	0.01	prophasm	9	na	runsapprox	xz	1305	11353	1372	9981	1320	1256	11353	4188	3492	364	3856	4268	spneumo_pangenome_k32.r_0.01.S_prophasm.k_9.d_na.M_runsapprox.C_xz
spneumo_pangenome_k32	0.05	prophasm	9	na	default	bzip	6527	49839	6527	43312	5414	5414	49839	17152	14192	797	14989	17800	spneumo_pangenome_k32.r_0.05.S_prophasm.k_9.d_na.M_default.C_bzip
spneumo_pangenome_k32	0.05	prophasm	9	na	default	xz	6527	49839	6527	43312	5414	5414	49839	17152	14192	1232	15424	17800	spneumo_pangenome_k32.r_0.05.S_prophasm.k_9.d_na.M_default.C_xz
spneumo_pangenome_k32	0.05	prophasm	9	na	ones	bzip	6527	49839	8186	41653	6945	5414	49839	17152	14192	2449	16641	18652	spneumo_pangenome_k32.r_0.05.S_prophasm.k_9.d_na.M_ones.C_bzip
spneumo_pangenome_k32	0.05	prophasm	9	na	ones	xz	6527	49839	8186	41653	6945	5414	49839	17152	14192	3040	17232	18652	spneumo_pangenome_k32.r_0.05.S_prophasm.k_9.d_na.M_ones.C_xz
spneumo_pangenome_k32	0.05	prophasm	9	na	runsapprox	bzip	6527	49839	8186	41653	6945	5414	49839	17152	14192	2449	16641	18652	spneumo_pangenome_k32.r_0.05.S_prophasm.k_9.d_na.M_runsapprox.C_bzip
spneumo_pangenome_k32	0.05	prophasm	9	na	runsapprox	xz	6527	49839	8186	41653	6945	5414	49839	17152	14192	3040	17232	18652	spneumo_pangenome_k32.r_0.05.S_prophasm.k_9.d_na.M_runsapprox.C_xz
spneumo_pangenome_k32	0.1	prophasm	9	na	default	bzip	13055	86199	13055	73144	9143	9143	86199	29320	24252	1931	26183	30748	spneumo_pangenome_k32.r_0.1.S_prophasm.k_9.d_na.M_default.C_bzip
spneumo_pangenome_k32	0.1	prophasm	9	na	default	xz	13055	86199	13055	73144	9143	9143	86199	29320	24252	2716	26968	30748	spneumo_pangenome_k32.r_0.1.S_prophasm.k_9.d_na.M_default.C_xz
spneumo_pangenome_k32	0.1	prophasm	9	na	ones	bzip	13055	86199	18769	67430	14107	9143	86199	29320	24252	6445	30697	33248	spneumo_pangenome_k32.r_0.1.S_prophasm.k_9.d_na.M_ones.C_bzip
spneumo_pangenome_k32	0.1	prophasm	9	na	ones	xz	13055	86199	18769	67430	14107	9143	86199	29320	24252	7500	31752	33248	spneumo_pangenome_k32.r_0.1.S_prophasm.k_9.d_na.M_ones.C_xz
spneumo_pangenome_k32	0.1	prophasm	9	na	runsapprox	bzip	13055	86199	18769	67430	14107	9143	86199	29320	24252	6445	30697	33248	spneumo_pangenome_k32.r_0.1.S_prophasm.k_9.d_na.M_runsapprox.C_bzip
spneumo_pangenome_k32	0.1	prophasm	9	na	runsapprox	xz	13055	86199	18769	67430	14107	9143	86199	29320	24252	7500	31752	33248	spneumo_pangenome_k32.r_0.1.S_prophasm.k_9.d_na.M_runsapprox.C_xz
spneumo_pangenome_k32	0.2	prophasm	9	na	default	bzip	26111	135791	26111	109680	13710	13710	135791	45708	37868	4019	41887	48500	spneumo_pangenome_k32.r_0.2.S_prophasm.k_9.d_na.M_default.C_bzip
spneumo_pangenome_k32	0.2	prophasm	9	na	default	xz	26111	135791	26111	109680	13710	13710	135791	45708	37868	5068	42936	48500	spneumo_pangenome_k32.r_0.2.S_prophasm.k_9.d_na.M_default.C_xz
spneumo_pangenome_k32	0.2	prophasm	9	na	ones	bzip	26111	135791	44173	91618	27146	13710	135791	45708	37868	15645	53513	54440	spneumo_pangenome_k32.r_0.2.S_prophasm.k_9.d_na.M_ones.C_bzip
spneumo_pangenome_k32	0.2	prophasm	9	na	ones	xz	26111	135791	44173	91618	27146	13710	135791	45708	37868	15680	53548	54440	spneumo_pangenome_k32.r_0.2.S_prophasm.k_9.d_na.M_ones.C_xz
spneumo_pangenome_k32	0.2	prophasm	9	na	runsapprox	bzip	26111	135791	44173	91618	27146	13710	135791	45708	37868	15645	53513	54440	spneumo_pangenome_k32.r_0.2.S_prophasm.k_9.d_na.M_runsapprox.C_bzip
spneumo_pangenome_k32	0.2	prophasm	9	na	runsapprox	xz	26111	135791	44173	91618	27146	13710	135791	45708	37868	15680	53548	54440	spneumo_pangenome_k32.r_0.2.S_prophasm.k_9.d_na.M_runsapprox.C_xz
spneumo_pangenome_k32	0.3	prophasm	9	na	default	bzip	39166	168878	39166	129712	16214	16214	168878	56360	47068	5524	52592	60148	spneumo_pangenome_k32.r_0.3.S_prophasm.k_9.d_na.M_default.C_bzip
spneumo_pangenome_k32	0.3	prophasm	9	na	default	xz	39166	168878	39166	129712	16214	16214	168878	56360	47068	6736	53804	60148	spneumo_pangenome_k32.r_0.3.S_prophasm.k_9.d_na.M_default.C_xz
spneumo_pangenome_k32	0.3	prophasm	9	na	ones	bzip	39166	168878	72149	96729	36966	16214	168878	56360	47068	23406	70474	68596	spneumo_pangenome_k32.r_0.3.S_prophasm.k_9.d_na.M_ones.C_bzip
spneumo_pangenome_k32	0.3	prophasm	9	na	ones	xz	39166	168878	72149	96729	36966	16214	168878	56360	47068	21504	68572	68596	spneumo_pangenome_k32.r_0.3.S_prophasm.k_9.d_na.M_ones.C_xz
spneumo_pangenome_k32	0.3	prophasm	9	na	runsapprox	bzip	39166	168878	72149	96729	36966	16214	168878	56360	47068	23406	70474	68596	spneumo_pangenome_k32.r_0.3.S_prophasm.k_9.d_na.M_runsapprox.C_bzip
spneumo_pangenome_k32	0.3	prophasm	9	na	runsapprox	xz	39166	168878	72149	96729	36966	16214	168878	56360	47068	21504	68572	68596	spneumo_pangenome_k32.r_0.3.S_prophasm.k_9.d_na.M_runsapprox.C_xz
spneumo_pangenome_k32	0.4	prophasm	9	na	default	bzip	52222	192422	52222	140200	17525	17525	192422	63340	53632	6517	60149	68316	spneumo_pangenome_k32.r_0.4.S_prophasm.k_9.d_na.M_default.C_bzip
spneumo_pangenome_k32	0.4	prophasm	9	na	default	xz	52222	192422	52222	140200	17525	17525	192422	63340	53632	7940	61572	68316	spneumo_pangenome_k32.r_0.4.S_prophasm.k_9.d_na.M_default.C_xz
spneumo_pangenome_k32	0.4	prophasm	9	na	ones	bzip	52222	192422	100816	91606	43049	17525	192422	63340	53632	28487	82119	78292	spneumo_pangenome_k32.r_0.4.S_prophasm.k_9.d_na.M_ones.C_bzip
spneumo_pangenome_k32	0.4	prophasm	9	na	ones	xz	52222	192422	100816	91606	43049	17525	192422	63340	53632	25064	78696	78292	spneumo_pangenome_k32.r_0.4.S_prophasm.k_9.d_na.M_ones.C_xz
spneumo_pangenome_k32	0.4	prophasm	9	na	runsapprox	bzip	52222	192422	100816	91606	43049	17525	192422	63340	53632	28487	82119	78292	spneumo_pangenome_k32.r_0.4.S_prophasm.k_9.d_na.M_runsapprox.C_bzip
spneumo_pangenome_k32	0.4	prophasm	9	na	runsapprox	xz	52222	192422	100816	91606	43049	17525	192422	63340	53632	25064	78696	78292	spneumo_pangenome_k32.r_0.4.S_prophasm.k_9.d_na.M_runsapprox.C_xz
spneumo_pangenome_k32	0.5	prophasm	9	na	default	bzip	65278	208838	65278	143560	17945	17945	208838	68548	58152	7142	65294	73724	spneumo_pangenome_k32.r_0.5.S_prophasm.k_9.d_na.M_default.C_bzip
spneumo_pangenome_k32	0.5	prophasm	9	na	default	xz	65278	208838	65278	143560	17945	17945	208838	68548	58152	8764	66916	73724	spneumo_pangenome_k32.r_0.5.S_prophasm.k_9.d_na.M_default.C_xz
spneumo_pangenome_k32	0.5	prophasm	9	na	ones	bzip	65278	208838	128739	80099	44593	17945	208838	68548	58152	30357	88509	84072	spneumo_pangenome_k32.r_0.5.S_prophasm.k_9.d_na.M_ones.C_bzip
spneumo_pangenome_k32	0.5	prophasm	9	na	ones	xz	65278	208838	128739	80099	44593	17945	208838	68548	58152	26396	84548	84072	spneumo_pangenome_k32.r_0.5.S_prophasm.k_9.d_na.M_ones.C_xz
spneumo_pangenome_k32	0.5	prophasm	9	na	runsapprox	bzip	65278	208838	128739	80099	44593	17945	208838	68548	58152	30357	88509	84072	spneumo_pangenome_k32.r_0.5.S_prophasm.k_9.d_na.M_runsapprox.C_bzip
spneumo_pangenome_k32	0.5	prophasm	9	na	runsapprox	xz	65278	208838	128739	80099	44593	17945	208838	68548	58152	26396	84548	84072	spneumo_pangenome_k32.r_0.5.S_prophasm.k_9.d_na.M_runsapprox.C_xz
spneumo_pangenome_k32	0.6	prophasm	9	na	default	bzip	78333	218605	78333	140272	17534	17534	218605	70716	60772	7524	68296	76208	spneumo_pangenome_k32.r_0.6.S_prophasm.k_9.d_na.M_default.C_bzip
spneumo_pangenome_k32	0.6	prophasm	9	na	default	xz	78333	218605	78333	140272	17534	17534	218605	70716	60772	9284	70056	76208	spneumo_pangenome_k32.r_0.6.S_prophasm.k_9.d_na.M_default.C_xz
spneumo_pangenome_k32	0.6	prophasm	9	na	ones	bzip	78333	218605	153774	64831	41409	17534	218605	70716	60772	29298	90070	86000	spneumo_pangenome_k32.r_0.6.S_prophasm.k_9.d_na.M_ones.C_bzip
spneumo_pangenome_k32	0.6	prophasm	9	na	ones	xz	78333	218605	153774	64831	41409	17534	218605	70716	60772	25808	86580	86000	spneumo_pangenome_k32.r_0.6.S_prophasm.k_9.d_na.M_ones.C_xz
spneumo_pangenome_k32	0.6	prophasm	9	na	runsapprox	bzip	78333	218605	153774	64831	41409	17534	218605	70716	60772	29298	90070	86000	spneumo_pangenome_k32.r_0.6.S_prophasm.k_9.d_na.M_runsapprox.C_bzip
spneumo_pangenome_k32	0.6	prophasm	9	na	runsapprox	xz	78333	218605	153774	64831	41409	17534	218605	70716	60772	25808	86580	86000	spneumo_pangenome_k32.r_0.6.S_prophasm.k_9.d_na.M_runsapprox.C_xz
spneumo_pangenome_k32	0.7	prophasm	9	na	default	bzip	91389	220933	91389	129544	16193	16193	220933	70236	61356	7496	68852	75888	spneumo_pangenome_k32.r_0.7.S_prophasm.k_9.d_na.M_default.C_bzip
spneumo_pangenome_k32	0.7	prophasm	9	na	default	xz	91389	220933	91389	129544	16193	16193	220933	70236	61356	9408	70764	75888	spneumo_pangenome_k32.r_0.7.S_prophasm.k_9.d_na.M_default.C_xz
spneumo_pangenome_k32	0.7	prophasm	9	na	ones	bzip	91389	220933	173515	47418	34257	16193	220933	70236	61356	25095	86451	83308	spneumo_pangenome_k32.r_0.7.S_prophasm.k_9.d_na.M_ones.C_bzip
spneumo_pangenome_k32	0.7	prophasm	9	na	ones	xz	91389	220933	173515	47418	34257	16193	220933	70236	61356	22952	84308	83308	spneumo_pangenome_k32.r_0.7.S_prophasm.k_9.d_na.M_ones.C_xz
spneumo_pangenome_k32	0.7	prophasm	9	na	runsapprox	bzip	91389	220933	173515	47418	34257	16193	220933	70236	61356	25095	86451	83308	spneumo_pangenome_k32.r_0.7.S_prophasm.k_9.d_na.M_runsapprox.C_bzip
spneumo_pangenome_k32	0.7	prophasm	9	na	runsapprox	xz	91389	220933	173515	47418	34257	16193	220933	70236	61356	22952	84308	83308	spneumo_pangenome_k32.r_0.7.S_prophasm.k_9.d_na.M_runsapprox.C_xz
spneumo_pangenome_k32	0.8	prophasm	9	na	default	bzip	104444	214140	104444	109696	13712	13712	214140	67404	59032	7046	66078	72068	spneumo_pangenome_k32.r_0.8.S_prophasm.k_9.d_na.M_default.C_bzip
spneumo_pangenome_k32	0.8	prophasm	9	na	default	xz	104444	214140	104444	109696	13712	13712	214140	67404	59032	9008	68040	72068	spneumo_pangenome_k32.r_0.8.S_prophasm.k_9.d_na.M_default.C_xz
spneumo_pangenome_k32	0.8	prophasm	9	na	ones	bzip	104444	214140	185335	28805	23405	13712	214140	67404	59032	18152	77184	75604	spneumo_pangenome_k32.r_0.8.S_prophasm.k_9.d_na.M_ones.C_bzip
spneumo_pangenome_k32	0.8	prophasm	9	na	ones	xz	104444	214140	185335	28805	23405	13712	214140	67404	59032	17300	76332	75604	spneumo_pangenome_k32.r_0.8.S_prophasm.k_9.d_na.M_ones.C_xz
spneumo_pangenome_k32	0.8	prophasm	9	na	runsapprox	bzip	104444	214140	185335	28805	23405	13712	214140	67404	59032	18152	77184	75604	spneumo_pangenome_k32.r_0.8.S_prophasm.k_9.d_na.M_runsapprox.C_bzip
spneumo_pangenome_k32	0.8	prophasm	9	na	runsapprox	xz	104444	214140	185335	28805	23405	13712	214140	67404	59032	17300	76332	75604	spneumo_pangenome_k32.r_0.8.S_prophasm.k_9.d_na.M_runsapprox.C_xz
spneumo_pangenome_k32	0.9	prophasm	9	na	default	bzip	117500	191580	117500	74080	9260	9260	191580	57504	51700	5705	57405	61208	spneumo_pangenome_k32.r_0.9.S_prophasm.k_9.d_na.M_default.C_bzip
spneumo_pangenome_k32	0.9	prophasm	9	na	default	xz	117500	191580	117500	74080	9260	9260	191580	57504	51700	7512	59212	61208	spneumo_pangenome_k32.r_0.9.S_prophasm.k_9.d_na.M_default.C_xz
spneumo_pangenome_k32	0.9	prophasm	9	na	ones	bzip	117500	191580	179376	12204	10957	9260	191580	57504	51700	9568	61268	60768	spneumo_pangenome_k32.r_0.9.S_prophasm.k_9.d_na.M_ones.C_bzip
spneumo_pangenome_k32	0.9	prophasm	9	na	ones	xz	117500	191580	179376	12204	10957	9260	191580	57504	51700	10096	61796	60768	spneumo_pangenome_k32.r_0.9.S_prophasm.k_9.d_na.M_ones.C_xz
spneumo_pangenome_k32	0.9	prophasm	9	na	runsapprox	bzip	117500	191580	179376	12204	10957	9260	191580	57504	51700	9568	61268	60768	spneumo_pangenome_k32.r_0.9.S_prophasm.k_9.d_na.M_runsapprox.C_bzip
spneumo_pangenome_k32	0.9	prophasm	9	na	runsapprox	xz	117500	191580	179376	12204	10957	9260	191580	57504	51700	10096	61796	60768	spneumo_pangenome_k32.r_0.9.S_prophasm.k_9.d_na.M_runsapprox.C_xz
spneumo_pangenome_k32	1.0	prophasm	9	na	default	bzip	130556	139060	130556	8504	1063	1063	139060	17364	16364	1117	17481	19704	spneumo_pangenome_k32.r_1.0.S_prophasm.k_9.d_na.M_default.C_bzip
spneumo_pangenome_k32	1.0	prophasm	9	na	default	xz	130556	139060	130556	8504	1063	1063	139060	17364	16364	1744	18108	19704	spneumo_pangenome_k32.r_1.0.S_prophasm.k_9.d_na.M_default.C_xz
spneumo_pangenome_k32	1.0	prophasm	9	na	ones	bzip	130556	139060	138622	438	329	1063	139060	17364	16364	644	17008	16844	spneumo_pangenome_k32.r_1.0.S_prophasm.k_9.d_na.M_ones.C_bzip
spneumo_pangenome_k32	1.0	prophasm	9	na	ones	xz	130556	139060	138622	438	329	1063	139060	17364	16364	956	17320	16844	spneumo_pangenome_k32.r_1.0.S_prophasm.k_9.d_na.M_ones.C_xz
spneumo_pangenome_k32	1.0	prophasm	9	na	runsapprox	bzip	130556	139060	138622	438	329	1063	139060	17364	16364	644	17008	16844	spneumo_pangenome_k32.r_1.0.S_prophasm.k_9.d_na.M_runsapprox.C_bzip
spneumo_pangenome_k32	1.0	prophasm	9	na	runsapprox	xz	130556	139060	138622	438	329	1063	139060	17364	16364	956	17320	16844	spneumo_pangenome_k32.r_1.0.S_prophasm.k_9.d_na.M_runsapprox.C_xz
spneumo_pangenome_k32	0.000000001	eulertigs	11	na	default	bzip	1	11	1	10	1	1	11	76	76	41	117	76	spneumo_pangenome_k32.r_0.000000001.S_eulertigs.k_11.d_na.M_default.C_bzip
spneumo_pangenome_k32	0.000000001	eulertigs	11	na	default	xz	1	11	1	10	1	1	11	76	76	76	152	76	spneumo_pangenome_k32.r_0.000000001.S_eulertigs.k_11.d_na.M_default.C_xz
spneumo_pangenome_k32	0.000000001	eulertigs	11	na	ones	bzip	1	11	1	10	1	1	11	76	76	41	117	76	spneumo_pangenome_k32.r_0.000000001.S_eulertigs.k_11.d_na.M_ones.C_bzip
spneumo_pangenome_k32	0.000000001	eulertigs	11	na	ones	xz	1	11	1	10	1	1	11	76	76	76	152	76	spneumo_pangenome_k32.r_0.000000001.S_eulertigs.k_11.d_na.M_ones.C_xz
spneumo_pangenome_k32	0.000000001	eulertigs	11	na	runsapprox	bzip	1	11	1	10	1	1	11	76	76	41	117	76	spneumo_pangenome_k32.r_0.000000001.S_eulertigs.k_11.d_na.M_runsapprox.C_bzip
spneumo_pangenome_k32	0.000000001	eulertigs	11	na	runsapprox	xz	1	11	1	10	1	1	11	76	76	76	152	76	spneumo_pangenome_k32.r_0.000000001.S_eulertigs.k_11.d_na.M_runsapprox.C_xz
spneumo_pangenome_k32	0.0001	eulertigs	11	na	default	bzip	154	1694	154	1540	154	154	1694	772	688	46	734	768	spneumo_pangenome_k32.r_0.0001.S_eulertigs.k_11.d_na.M_default.C_bzip
spneumo_pangenome_k32	0.0001	eulertigs	11	na	default	xz	154	1694	154	1540	154	154	1694	772	688	92	780	768	spneumo_pangenome_k32.r_0.0001.S_eulertigs.k_11.d_na.M_default.C_xz
spneumo_pangenome_k32	0.0001	eulertigs	11	na	ones	bzip	154	1694	154	1540	154	154	1694	772	688	46	734	768	spneumo_pangenome_k32.r_0.0001.S_eulertigs.k_11.d_na.M_ones.C_bzip
spneumo_pangenome_k32	0.0001	eulertigs	11	na	ones	xz	154	1694	154	1540	154	154	1694	772	688	92	780	768	spneumo_pangenome_k32.r_0.0001.S_eulertigs.k_11.d_na.M_ones.C_xz
spneumo_pangenome_k32	0.0001	eulertigs	11	na	runsapprox	bzip	154	1694	154	1540	154	154	1694	772	688	46	734	768	spneumo_pangenome_k32.r_0.0001.S_eulertigs.k_11.d_na.M_runsapprox.C_bzip
spneumo_pangenome_k32	0.0001	eulertigs	11	na	runsapprox	xz	154	1694	154	1540	154	154	1694	772	688	92	780	768	spneumo_pangenome_k32.r_0.0001.S_eulertigs.k_11.d_na.M_runsapprox.C_xz
spneumo_pangenome_k32	0.001	eulertigs	11	na	default	bzip	1545	16965	1545	15420	1542	1542	16965	5008	4640	51	4691	5048	spneumo_pangenome_k32.r_0.001.S_eulertigs.k_11.d_na.M_default.C_bzip
spneumo_pangenome_k32	0.001	eulertigs	11	na	default	xz	1545	16965	1545	15420	1542	1542	16965	5008	4640	144	4784	5048	spneumo_pangenome_k32.r_0.001.S_eulertigs.k_11.d_na.M_default.C_xz
spneumo_pangenome_k32	0.001	eulertigs	11	na	ones	bzip	1545	16965	1553	15412	1549	1542	16965	5008	4640	80	4720	5048	spneumo_pangenome_k32.r_0.001.S_eulertigs.k_11.d_na.M_ones.C_bzip
spneumo_pangenome_k32	0.001	eulertigs	11	na	ones	xz	1545	16965	1553	15412	1549	1542	16965	5008	4640	172	4812	5048	spneumo_pangenome_k32.r_0.001.S_eulertigs.k_11.d_na.M_ones.C_xz
spneumo_pangenome_k32	0.001	eulertigs	11	na	runsapprox	bzip	1545	16965	1553	15412	1549	1542	16965	5008	4640	80	4720	5048	spneumo_pangenome_k32.r_0.001.S_eulertigs.k_11.d_na.M_runsapprox.C_bzip
spneumo_pangenome_k32	0.001	eulertigs	11	na	runsapprox	xz	1545	16965	1553	15412	1549	1542	16965	5008	4640	172	4812	5048	spneumo_pangenome_k32.r_0.001.S_eulertigs.k_11.d_na.M_runsapprox.C_xz
spneumo_pangenome_k32	0.01	eulertigs	11	na	default	bzip	15452	164822	15452	149370	14937	14937	164822	48672	43744	760	44504	49824	spneumo_pangenome_k32.r_0.01.S_eulertigs.k_11.d_na.M_default.C_bzip
spneumo_pangenome_k32	0.01	eulertigs	11	na	default	xz	15452	164822	15452	149370	14937	14937	164822	48672	43744	1320	45064	49824	spneumo_pangenome_k32.r_0.01.S_eulertigs.k_11.d_na.M_default.C_xz
spneumo_pangenome_k32	0.01	eulertigs	11	na	ones	bzip	15452	164822	16444	148378	15921	14937	164822	48672	43744	2196	45940	50788	spneumo_pangenome_k32.r_0.01.S_eulertigs.k_11.d_na.M_ones.C_bzip
spneumo_pangenome_k32	0.01	eulertigs	11	na	ones	xz	15452	164822	16444	148378	15921	14937	164822	48672	43744	3432	47176	50788	spneumo_pangenome_k32.r_0.01.S_eulertigs.k_11.d_na.M_ones.C_xz
spneumo_pangenome_k32	0.01	eulertigs	11	na	runsapprox	bzip	15452	164822	16444	148378	15921	14937	164822	48672	43744	2196	45940	50788	spneumo_pangenome_k32.r_0.01.S_eulertigs.k_11.d_na.M_runsapprox.C_bzip
spneumo_pangenome_k32	0.01	eulertigs	11	na	runsapprox	xz	15452	164822	16444	148378	15921	14937	164822	48672	43744	3432	47176	50788	spneumo_pangenome_k32.r_0.01.S_eulertigs.k_11.d_na.M_runsapprox.C_xz
spneumo_pangenome_k32	0.05	eulertigs	11	na	default	bzip	77264	735414	77264	658150	65815	65815	735414	226624	196772	8689	205461	234748	spneumo_pangenome_k32.r_0.05.S_eulertigs.k_11.d_na.M_default.C_bzip
spneumo_pangenome_k32	0.05	eulertigs	11	na	default	xz	77264	735414	77264	658150	65815	65815	735414	226624	196772	12968	209740	234748	spneumo_pangenome_k32.r_0.05.S_eulertigs.k_11.d_na.M_default.C_xz
spneumo_pangenome_k32	0.05	eulertigs	11	na	ones	bzip	77264	735414	98860	636554	86250	65815	735414	226624	196772	29912	226684	249524	spneumo_pangenome_k32.r_0.05.S_eulertigs.k_11.d_na.M_ones.C_bzip
spneumo_pangenome_k32	0.05	eulertigs	11	na	ones	xz	77264	735414	98860	636554	86250	65815	735414	226624	196772	36420	233192	249524	spneumo_pangenome_k32.r_0.05.S_eulertigs.k_11.d_na.M_ones.C_xz
spneumo_pangenome_k32	0.05	eulertigs	11	na	runsapprox	bzip	77264	735414	98860	636554	86250	65815	735414	226624	196772	29912	226684	249524	spneumo_pangenome_k32.r_0.05.S_eulertigs.k_11.d_na.M_runsapprox.C_bzip
spneumo_pangenome_k32	0.05	eulertigs	11	na	runsapprox	xz	77264	735414	98860	636554	86250	65815	735414	226624	196772	36420	233192	249524	spneumo_pangenome_k32.r_0.05.S_eulertigs.k_11.d_na.M_runsapprox.C_xz
spneumo_pangenome_k32	0.1	eulertigs	11	na	default	bzip	154528	1289118	154528	1134590	113459	113459	1289118	401712	344888	22275	367163	418788	spneumo_pangenome_k32.r_0.1.S_eulertigs.k_11.d_na.M_default.C_bzip
spneumo_pangenome_k32	0.1	eulertigs	11	na	default	xz	154528	1289118	154528	1134590	113459	113459	1289118	401712	344888	32048	376936	418788	spneumo_pangenome_k32.r_0.1.S_eulertigs.k_11.d_na.M_default.C_xz
spneumo_pangenome_k32	0.1	eulertigs	11	na	ones	bzip	154528	1289118	229895	1059223	180472	113459	1289118	401712	344888	82243	427131	462720	spneumo_pangenome_k32.r_0.1.S_eulertigs.k_11.d_na.M_ones.C_bzip
spneumo_pangenome_k32	0.1	eulertigs	11	na	ones	xz	154528	1289118	229895	1059223	180472	113459	1289118	401712	344888	92344	437232	462720	spneumo_pangenome_k32.r_0.1.S_eulertigs.k_11.d_na.M_ones.C_xz
spneumo_pangenome_k32	0.1	eulertigs	11	na	runsapprox	bzip	154528	1289118	229895	1059223	180472	113459	1289118	401712	344888	82243	427131	462720	spneumo_pangenome_k32.r_0.1.S_eulertigs.k_11.d_na.M_runsapprox.C_bzip
spneumo_pangenome_k32	0.1	eulertigs	11	na	runsapprox	xz	154528	1289118	229895	1059223	180472	113459	1289118	401712	344888	92344	437232	462720	spneumo_pangenome_k32.r_0.1.S_eulertigs.k_11.d_na.M_runsapprox.C_xz
spneumo_pangenome_k32	0.2	eulertigs	11	na	default	bzip	309056	2069406	309056	1760350	176035	176035	2069406	649952	551808	50541	602349	685120	spneumo_pangenome_k32.r_0.2.S_eulertigs.k_11.d_na.M_default.C_bzip
spneumo_pangenome_k32	0.2	eulertigs	11	na	default	xz	309056	2069406	309056	1760350	176035	176035	2069406	649952	551808	66548	618356	685120	spneumo_pangenome_k32.r_0.2.S_eulertigs.k_11.d_na.M_default.C_xz
spneumo_pangenome_k32	0.2	eulertigs	11	na	ones	bzip	309056	2069406	548914	1520492	364121	176035	2069406	649952	551808	209737	761545	789504	spneumo_pangenome_k32.r_0.2.S_eulertigs.k_11.d_na.M_ones.C_bzip
spneumo_pangenome_k32	0.2	eulertigs	11	na	ones	xz	309056	2069406	548914	1520492	364121	176035	2069406	649952	551808	210160	761968	789504	spneumo_pangenome_k32.r_0.2.S_eulertigs.k_11.d_na.M_ones.C_xz
spneumo_pangenome_k32	0.2	eulertigs	11	na	runsapprox	bzip	309056	2069406	548914	1520492	364121	176035	2069406	649952	551808	209737	761545	789504	spneumo_pangenome_k32.r_0.2.S_eulertigs.k_11.d_na.M_runsapprox.C_bzip
spneumo_pangenome_k32	0.2	eulertigs	11	na	runsapprox	xz	309056	2069406	548914	1520492	364121	176035	2069406	649952	551808	210160	761968	789504	spneumo_pangenome_k32.r_0.2.S_eulertigs.k_11.d_na.M_runsapprox.C_xz
spneumo_pangenome_k32	0.3	eulertigs	11	na	default	bzip	463584	2590004	463584	2126420	212642	212642	2590004	812572	694640	75290	769930	869736	spneumo_pangenome_k32.r_0.3.S_eulertigs.k_11.d_na.M_default.C_bzip
spneumo_pangenome_k32	0.3	eulertigs	11	na	default	xz	463584	2590004	463584	2126420	212642	212642	2590004	812572	694640	94144	788784	869736	spneumo_pangenome_k32.r_0.3.S_eulertigs.k_11.d_na.M_default.C_xz
spneumo_pangenome_k32	0.3	eulertigs	11	na	ones	bzip	463584	2590004	903980	1686024	515752	212642	2590004	812572	694640	331501	1026141	1016552	spneumo_pangenome_k32.r_0.3.S_eulertigs.k_11.d_na.M_ones.C_bzip
spneumo_pangenome_k32	0.3	eulertigs	11	na	ones	xz	463584	2590004	903980	1686024	515752	212642	2590004	812572	694640	307768	1002408	1016552	spneumo_pangenome_k32.r_0.3.S_eulertigs.k_11.d_na.M_ones.C_xz
spneumo_pangenome_k32	0.3	eulertigs	11	na	runsapprox	bzip	463584	2590004	903980	1686024	515752	212642	2590004	812572	694640	331501	1026141	1016552	spneumo_pangenome_k32.r_0.3.S_eulertigs.k_11.d_na.M_runsapprox.C_bzip
spneumo_pangenome_k32	0.3	eulertigs	11	na	runsapprox	xz	463584	2590004	903980	1686024	515752	212642	2590004	812572	694640	307768	1002408	1016552	spneumo_pangenome_k32.r_0.3.S_eulertigs.k_11.d_na.M_runsapprox.C_xz
spneumo_pangenome_k32	0.4	eulertigs	11	na	default	bzip	618112	2951292	618112	2333180	233318	233318	2951292	927108	790992	94852	885844	1009516	spneumo_pangenome_k32.r_0.4.S_eulertigs.k_11.d_na.M_default.C_bzip
spneumo_pangenome_k32	0.4	eulertigs	11	na	default	xz	618112	2951292	618112	2333180	233318	233318	2951292	927108	790992	115080	906072	1009516	spneumo_pangenome_k32.r_0.4.S_eulertigs.k_11.d_na.M_default.C_xz
spneumo_pangenome_k32	0.4	eulertigs	11	na	ones	bzip	618112	2951292	1273434	1677858	620773	233318	2951292	927108	790992	423900	1214892	1171700	spneumo_pangenome_k32.r_0.4.S_eulertigs.k_11.d_na.M_ones.C_bzip
spneumo_pangenome_k32	0.4	eulertigs	11	na	ones	xz	618112	2951292	1273434	1677858	620773	233318	2951292	927108	790992	374648	1165640	1171700	spneumo_pangenome_k32.r_0.4.S_eulertigs.k_11.d_na.M_ones.C_xz
spneumo_pangenome_k32	0.4	eulertigs	11	na	runsapprox	bzip	618112	2951292	1273434	1677858	620773	233318	2951292	927108	790992	423900	1214892	1171700	spneumo_pangenome_k32.r_0.4.S_eulertigs.k_11.d_na.M_runsapprox.C_bzip
spneumo_pangenome_k32	0.4	eulertigs	11	na	runsapprox	xz	618112	2951292	1273434	1677858	620773	233318	2951292	927108	790992	374648	1165640	1171700	spneumo_pangenome_k32.r_0.4.S_eulertigs.k_11.d_na.M_runsapprox.C_xz
spneumo_pangenome_k32	0.5	eulertigs	11	na	default	bzip	772641	3200091	772641	2427450	242745	242745	3200091	1001968	854656	108934	963590	1094676	spneumo_pangenome_k32.r_0.5.S_eulertigs.k_11.d_na.M_default.C_bzip
spneumo_pangenome_k32	0.5	eulertigs	11	na	default	xz	772641	3200091	772641	2427450	242745	242745	3200091	1001968	854656	129836	984492	1094676	spneumo_pangenome_k32.r_0.5.S_eulertigs.k_11.d_na.M_default.C_xz
spneumo_pangenome_k32	0.5	eulertigs	11	na	ones	bzip	772641	3200091	1636844	1563247	674713	242745	3200091	1001968	854656	479651	1334307	1282868	spneumo_pangenome_k32.r_0.5.S_eulertigs.k_11.d_na.M_ones.C_bzip
spneumo_pangenome_k32	0.5	eulertigs	11	na	ones	xz	772641	3200091	1636844	1563247	674713	242745	3200091	1001968	854656	412240	1266896	1282868	spneumo_pangenome_k32.r_0.5.S_eulertigs.k_11.d_na.M_ones.C_xz
spneumo_pangenome_k32	0.5	eulertigs	11	na	runsapprox	bzip	772641	3200091	1636844	1563247	674713	242745	3200091	1001968	854656	479651	1334307	1282868	spneumo_pangenome_k32.r_0.5.S_eulertigs.k_11.d_na.M_runsapprox.C_bzip
spneumo_pangenome_k32	0.5	eulertigs	11	na	runsapprox	xz	772641	3200091	1636844	1563247	674713	242745	3200091	1001968	854656	412240	1266896	1282868	spneumo_pangenome_k32.r_0.5.S_eulertigs.k_11.d_na.M_runsapprox.C_xz
spneumo_pangenome_k32	0.6	eulertigs	11	na	default	bzip	927169	3348759	927169	2421590	242159	242159	3348759	1037408	910444	118380	1028824	1142368	spneumo_pangenome_k32.r_0.6.S_eulertigs.k_11.d_na.M_default.C_bzip
spneumo_pangenome_k32	0.6	eulertigs	11	na	default	xz	927169	3348759	927169	2421590	242159	242159	3348759	1037408	910444	138284	1048728	1142368	spneumo_pangenome_k32.r_0.6.S_eulertigs.k_11.d_na.M_default.C_xz
spneumo_pangenome_k32	0.6	eulertigs	11	na	ones	bzip	927169	3348759	1973170	1375589	671317	242159	3348759	1037408	910444	495548	1405992	1323772	spneumo_pangenome_k32.r_0.6.S_eulertigs.k_11.d_na.M_ones.C_bzip
spneumo_pangenome_k32	0.6	eulertigs	11	na	ones	xz	927169	3348759	1973170	1375589	671317	242159	3348759	1037408	910444	422896	1333340	1323772	spneumo_pangenome_k32.r_0.6.S_eulertigs.k_11.d_na.M_ones.C_xz
spneumo_pangenome_k32	0.6	eulertigs	11	na	runsapprox	bzip	927169	3348759	1973170	1375589	671317	242159	3348759	1037408	910444	495548	1405992	1323772	spneumo_pangenome_k32.r_0.6.S_eulertigs.k_11.d_na.M_runsapprox.C_bzip
spneumo_pangenome_k32	0.6	eulertigs	11	na	runsapprox	xz	927169	3348759	1973170	1375589	671317	242159	3348759	1037408	910444	422896	1333340	1323772	spneumo_pangenome_k32.r_0.6.S_eulertigs.k_11.d_na.M_runsapprox.C_xz
spneumo_pangenome_k32	0.7	eulertigs	11	na	default	bzip	1081697	3392127	1081697	2310430	231043	231043	3392127	1050048	920516	122283	1042799	1155464	spneumo_pangenome_k32.r_0.7.S_eulertigs.k_11.d_na.M_default.C_bzip
spneumo_pangenome_k32	0.7	eulertigs	11	na	default	xz	1081697	3392127	1081697	2310430	231043	231043	3392127	1050048	920516	141564	1062080	1155464	spneumo_pangenome_k32.r_0.7.S_eulertigs.k_11.d_na.M_default.C_xz
spneumo_pangenome_k32	0.7	eulertigs	11	na	ones	bzip	1081697	3392127	2257083	1135044	610341	231043	3392127	1050048	920516	471201	1391717	1313512	spneumo_pangenome_k32.r_0.7.S_eulertigs.k_11.d_na.M_ones.C_bzip
spneumo_pangenome_k32	0.7	eulertigs	11	na	ones	xz	1081697	3392127	2257083	1135044	610341	231043	3392127	1050048	920516	406652	1327168	1313512	spneumo_pangenome_k32.r_0.7.S_eulertigs.k_11.d_na.M_ones.C_xz
spneumo_pangenome_k32	0.7	eulertigs	11	na	runsapprox	bzip	1081697	3392127	2257083	1135044	610341	231043	3392127	1050048	920516	471201	1391717	1313512	spneumo_pangenome_k32.r_0.7.S_eulertigs.k_11.d_na.M_runsapprox.C_bzip
spneumo_pangenome_k32	0.7	eulertigs	11	na	runsapprox	xz	1081697	3392127	2257083	1135044	610341	231043	3392127	1050048	920516	406652	1327168	1313512	spneumo_pangenome_k32.r_0.7.S_eulertigs.k_11.d_na.M_runsapprox.C_xz
spneumo_pangenome_k32	0.8	eulertigs	11	na	default	bzip	1236225	3312925	1236225	2076700	207670	207670	3312925	1014624	892024	118710	1010734	1122800	spneumo_pangenome_k32.r_0.8.S_eulertigs.k_11.d_na.M_default.C_bzip
spneumo_pangenome_k32	0.8	eulertigs	11	na	default	xz	1236225	3312925	1236225	2076700	207670	207670	3312925	1014624	892024	138528	1030552	1122800	spneumo_pangenome_k32.r_0.8.S_eulertigs.k_11.d_na.M_default.C_xz
spneumo_pangenome_k32	0.8	eulertigs	11	na	ones	bzip	1236225	3312925	2448274	864651	494906	207670	3312925	1014624	892024	402268	1294292	1246212	spneumo_pangenome_k32.r_0.8.S_eulertigs.k_11.d_na.M_ones.C_bzip
spneumo_pangenome_k32	0.8	eulertigs	11	na	ones	xz	1236225	3312925	2448274	864651	494906	207670	3312925	1014624	892024	360280	1252304	1246212	spneumo_pangenome_k32.r_0.8.S_eulertigs.k_11.d_na.M_ones.C_xz
spneumo_pangenome_k32	0.8	eulertigs	11	na	runsapprox	bzip	1236225	3312925	2448274	864651	494906	207670	3312925	1014624	892024	402268	1294292	1246212	spneumo_pangenome_k32.r_0.8.S_eulertigs.k_11.d_na.M_runsapprox.C_bzip
spneumo_pangenome_k32	0.8	eulertigs	11	na	runsapprox	xz	1236225	3312925	2448274	864651	494906	207670	3312925	1014624	892024	360280	1252304	1246212	spneumo_pangenome_k32.r_0.8.S_eulertigs.k_11.d_na.M_runsapprox.C_xz
spneumo_pangenome_k32	0.9	eulertigs	11	na	default	bzip	1390753	3071723	1390753	1680970	168097	168097	3071723	938788	823052	105906	928958	1029848	spneumo_pangenome_k32.r_0.9.S_eulertigs.k_11.d_na.M_default.C_bzip
spneumo_pangenome_k32	0.9	eulertigs	11	na	default	xz	1390753	3071723	1390753	1680970	168097	168097	3071723	938788	823052	126008	949060	1029848	spneumo_pangenome_k32.r_0.9.S_eulertigs.k_11.d_na.M_default.C_xz
spneumo_pangenome_k32	0.9	eulertigs	11	na	ones	bzip	1390753	3071723	2485000	586723	340527	168097	3071723	938788	823052	302997	1126049	1099816	spneumo_pangenome_k32.r_0.9.S_eulertigs.k_11.d_na.M_ones.C_bzip
spneumo_pangenome_k32	0.9	eulertigs	11	na	ones	xz	1390753	3071723	2485000	586723	340527	168097	3071723	938788	823052	282948	1106000	1099816	spneumo_pangenome_k32.r_0.9.S_eulertigs.k_11.d_na.M_ones.C_xz
spneumo_pangenome_k32	0.9	eulertigs	11	na	runsapprox	bzip	1390753	3071723	2485000	586723	340527	168097	3071723	938788	823052	302997	1126049	1099816	spneumo_pangenome_k32.r_0.9.S_eulertigs.k_11.d_na.M_runsapprox.C_bzip
spneumo_pangenome_k32	0.9	eulertigs	11	na	runsapprox	xz	1390753	3071723	2485000	586723	340527	168097	3071723	938788	823052	282948	1106000	1099816	spneumo_pangenome_k32.r_0.9.S_eulertigs.k_11.d_na.M_runsapprox.C_xz
spneumo_pangenome_k32	1.0	eulertigs	11	na	default	bzip	1545282	2529652	1545282	984370	98437	98437	2529652	756344	685820	73028	758848	823236	spneumo_pangenome_k32.r_1.0.S_eulertigs.k_11.d_na.M_default.C_bzip
spneumo_pangenome_k32	1.0	eulertigs	11	na	default	xz	1545282	2529652	1545282	984370	98437	98437	2529652	756344	685820	91744	777564	823236	spneumo_pangenome_k32.r_1.0.S_eulertigs.k_11.d_na.M_default.C_xz
spneumo_pangenome_k32	1.0	eulertigs	11	na	ones	bzip	1545282	2529652	2201001	328651	170741	98437	2529652	756344	685820	175398	861218	842280	spneumo_pangenome_k32.r_1.0.S_eulertigs.k_11.d_na.M_ones.C_bzip
spneumo_pangenome_k32	1.0	eulertigs	11	na	ones	xz	1545282	2529652	2201001	328651	170741	98437	2529652	756344	685820	174100	859920	842280	spneumo_pangenome_k32.r_1.0.S_eulertigs.k_11.d_na.M_ones.C_xz
spneumo_pangenome_k32	1.0	eulertigs	11	na	runsapprox	bzip	1545282	2529652	2201001	328651	170741	98437	2529652	756344	685820	175398	861218	842280	spneumo_pangenome_k32.r_1.0.S_eulertigs.k_11.d_na.M_runsapprox.C_bzip
spneumo_pangenome_k32	1.0	eulertigs	11	na	runsapprox	xz	1545282	2529652	2201001	328651	170741	98437	2529652	756344	685820	174100	859920	842280	spneumo_pangenome_k32.r_1.0.S_eulertigs.k_11.d_na.M_runsapprox.C_xz
spneumo_pangenome_k32	0.000000001	greedytigs	11	na	default	bzip	1	11	1	10	1	1	11	76	76	41	117	76	spneumo_pangenome_k32.r_0.000000001.S_greedytigs.k_11.d_na.M_default.C_bzip
spneumo_pangenome_k32	0.000000001	greedytigs	11	na	default	xz	1	11	1	10	1	1	11	76	76	76	152	76	spneumo_pangenome_k32.r_0.000000001.S_greedytigs.k_11.d_na.M_default.C_xz
spneumo_pangenome_k32	0.000000001	greedytigs	11	na	ones	bzip	1	11	1	10	1	1	11	76	76	41	117	76	spneumo_pangenome_k32.r_0.000000001.S_greedytigs.k_11.d_na.M_ones.C_bzip
spneumo_pangenome_k32	0.000000001	greedytigs	11	na	ones	xz	1	11	1	10	1	1	11	76	76	76	152	76	spneumo_pangenome_k32.r_0.000000001.S_greedytigs.k_11.d_na.M_ones.C_xz
spneumo_pangenome_k32	0.000000001	greedytigs	11	na	runsapprox	bzip	1	11	1	10	1	1	11	76	76	41	117	76	spneumo_pangenome_k32.r_0.000000001.S_greedytigs.k_11.d_na.M_runsapprox.C_bzip
spneumo_pangenome_k32	0.000000001	greedytigs	11	na	runsapprox	xz	1	11	1	10	1	1	11	76	76	76	152	76	spneumo_pangenome_k32.r_0.000000001.S_greedytigs.k_11.d_na.M_runsapprox.C_xz
spneumo_pangenome_k32	0.0001	greedytigs	11	na	default	bzip	154	1694	154	1540	154	154	1694	772	688	46	734	768	spneumo_pangenome_k32.r_0.0001.S_greedytigs.k_11.d_na.M_default.C_bzip
spneumo_pangenome_k32	0.0001	greedytigs	11	na	default	xz	154	1694	154	1540	154	154	1694	772	688	92	780	768	spneumo_pangenome_k32.r_0.0001.S_greedytigs.k_11.d_na.M_default.C_xz
spneumo_pangenome_k32	0.0001	greedytigs	11	na	ones	bzip	154	1694	154	1540	154	154	1694	772	688	46	734	768	spneumo_pangenome_k32.r_0.0001.S_greedytigs.k_11.d_na.M_ones.C_bzip
spneumo_pangenome_k32	0.0001	greedytigs	11	na	ones	xz	154	1694	154	1540	154	154	1694	772	688	92	780	768	spneumo_pangenome_k32.r_0.0001.S_greedytigs.k_11.d_na.M_ones.C_xz
spneumo_pangenome_k32	0.0001	greedytigs	11	na	runsapprox	bzip	154	1694	154	1540	154	154	1694	772	688	46	734	768	spneumo_pangenome_k32.r_0.0001.S_greedytigs.k_11.d_na.M_runsapprox.C_bzip
spneumo_pangenome_k32	0.0001	greedytigs	11	na	runsapprox	xz	154	1694	154	1540	154	154	1694	772	688	92	780	768	spneumo_pangenome_k32.r_0.0001.S_greedytigs.k_11.d_na.M_runsapprox.C_xz
spneumo_pangenome_k32	0.001	greedytigs	11	na	default	bzip	1545	16965	1545	15420	1542	1542	16965	5008	4640	51	4691	5048	spneumo_pangenome_k32.r_0.001.S_greedytigs.k_11.d_na.M_default.C_bzip
spneumo_pangenome_k32	0.001	greedytigs	11	na	default	xz	1545	16965	1545	15420	1542	1542	16965	5008	4640	144	4784	5048	spneumo_pangenome_k32.r_0.001.S_greedytigs.k_11.d_na.M_default.C_xz
spneumo_pangenome_k32	0.001	greedytigs	11	na	ones	bzip	1545	16965	1553	15412	1549	1542	16965	5008	4640	80	4720	5048	spneumo_pangenome_k32.r_0.001.S_greedytigs.k_11.d_na.M_ones.C_bzip
spneumo_pangenome_k32	0.001	greedytigs	11	na	ones	xz	1545	16965	1553	15412	1549	1542	16965	5008	4640	172	4812	5048	spneumo_pangenome_k32.r_0.001.S_greedytigs.k_11.d_na.M_ones.C_xz
spneumo_pangenome_k32	0.001	greedytigs	11	na	runsapprox	bzip	1545	16965	1553	15412	1549	1542	16965	5008	4640	80	4720	5048	spneumo_pangenome_k32.r_0.001.S_greedytigs.k_11.d_na.M_runsapprox.C_bzip
spneumo_pangenome_k32	0.001	greedytigs	11	na	runsapprox	xz	1545	16965	1553	15412	1549	1542	16965	5008	4640	172	4812	5048	spneumo_pangenome_k32.r_0.001.S_greedytigs.k_11.d_na.M_runsapprox.C_xz
spneumo_pangenome_k32	0.01	greedytigs	11	na	default	bzip	15452	164822	15452	149370	14937	14937	164822	48672	43744	760	44504	49824	spneumo_pangenome_k32.r_0.01.S_greedytigs.k_11.d_na.M_default.C_bzip
spneumo_pangenome_k32	0.01	greedytigs	11	na	default	xz	15452	164822	15452	149370	14937	14937	164822	48672	43744	1320	45064	49824	spneumo_pangenome_k32.r_0.01.S_greedytigs.k_11.d_na.M_default.C_xz
spneumo_pangenome_k32	0.01	greedytigs	11	na	ones	bzip	15452	164822	16444	148378	15921	14937	164822	48672	43744	2196	45940	50788	spneumo_pangenome_k32.r_0.01.S_greedytigs.k_11.d_na.M_ones.C_bzip
spneumo_pangenome_k32	0.01	greedytigs	11	na	ones	xz	15452	164822	16444	148378	15921	14937	164822	48672	43744	3432	47176	50788	spneumo_pangenome_k32.r_0.01.S_greedytigs.k_11.d_na.M_ones.C_xz
spneumo_pangenome_k32	0.01	greedytigs	11	na	runsapprox	bzip	15452	164822	16444	148378	15921	14937	164822	48672	43744	2196	45940	50788	spneumo_pangenome_k32.r_0.01.S_greedytigs.k_11.d_na.M_runsapprox.C_bzip
spneumo_pangenome_k32	0.01	greedytigs	11	na	runsapprox	xz	15452	164822	16444	148378	15921	14937	164822	48672	43744	3432	47176	50788	spneumo_pangenome_k32.r_0.01.S_greedytigs.k_11.d_na.M_runsapprox.C_xz
spneumo_pangenome_k32	0.05	greedytigs	11	na	default	bzip	77264	735387	77267	658120	65812	65812	735387	227736	197048	8696	205744	233372	spneumo_pangenome_k32.r_0.05.S_greedytigs.k_11.d_na.M_default.C_bzip
spneumo_pangenome_k32	0.05	greedytigs	11	na	default	xz	77264	735387	77267	658120	65812	65812	735387	227736	197048	12992	210040	233372	spneumo_pangenome_k32.r_0.05.S_greedytigs.k_11.d_na.M_default.C_xz
spneumo_pangenome_k32	0.05	greedytigs	11	na	ones	bzip	77264	735387	99118	636269	86394	65812	735387	227736	197048	30109	227157	249564	spneumo_pangenome_k32.r_0.05.S_greedytigs.k_11.d_na.M_ones.C_bzip
spneumo_pangenome_k32	0.05	greedytigs	11	na	ones	xz	77264	735387	99118	636269	86394	65812	735387	227736	197048	36476	233524	249564	spneumo_pangenome_k32.r_0.05.S_greedytigs.k_11.d_na.M_ones.C_xz
spneumo_pangenome_k32	0.05	greedytigs	11	na	runsapprox	bzip	77264	735387	99118	636269	86394	65812	735387	227736	197048	30109	227157	249564	spneumo_pangenome_k32.r_0.05.S_greedytigs.k_11.d_na.M_runsapprox.C_bzip
spneumo_pangenome_k32	0.05	greedytigs	11	na	runsapprox	xz	77264	735387	99118	636269	86394	65812	735387	227736	197048	36476	233524	249564	spneumo_pangenome_k32.r_0.05.S_greedytigs.k_11.d_na.M_runsapprox.C_xz
spneumo_pangenome_k32	0.1	greedytigs	11	na	default	bzip	154528	1287607	154777	1132830	113283	113283	1287607	404224	347460	22411	369871	416492	spneumo_pangenome_k32.r_0.1.S_greedytigs.k_11.d_na.M_default.C_bzip
spneumo_pangenome_k32	0.1	greedytigs	11	na	default	xz	154528	1287607	154777	1132830	113283	113283	1287607	404224	347460	32148	379608	416492	spneumo_pangenome_k32.r_0.1.S_greedytigs.k_11.d_na.M_default.C_xz
spneumo_pangenome_k32	0.1	greedytigs	11	na	ones	bzip	154528	1287607	229972	1057635	180314	113283	1287607	404224	347460	82209	429669	462436	spneumo_pangenome_k32.r_0.1.S_greedytigs.k_11.d_na.M_ones.C_bzip
spneumo_pangenome_k32	0.1	greedytigs	11	na	ones	xz	154528	1287607	229972	1057635	180314	113283	1287607	404224	347460	91988	439448	462436	spneumo_pangenome_k32.r_0.1.S_greedytigs.k_11.d_na.M_ones.C_xz
spneumo_pangenome_k32	0.1	greedytigs	11	na	runsapprox	bzip	154528	1287607	229972	1057635	180314	113283	1287607	404224	347460	82209	429669	462436	spneumo_pangenome_k32.r_0.1.S_greedytigs.k_11.d_na.M_runsapprox.C_bzip
spneumo_pangenome_k32	0.1	greedytigs	11	na	runsapprox	xz	154528	1287607	229972	1057635	180314	113283	1287607	404224	347460	91988	439448	462436	spneumo_pangenome_k32.r_0.1.S_greedytigs.k_11.d_na.M_runsapprox.C_xz
spneumo_pangenome_k32	0.2	greedytigs	11	na	default	bzip	309056	2039753	316953	1722800	172280	172280	2039753	642692	550780	52145	602925	675204	spneumo_pangenome_k32.r_0.2.S_greedytigs.k_11.d_na.M_default.C_bzip
spneumo_pangenome_k32	0.2	greedytigs	11	na	default	xz	309056	2039753	316953	1722800	172280	172280	2039753	642692	550780	67552	618332	675204	spneumo_pangenome_k32.r_0.2.S_greedytigs.k_11.d_na.M_default.C_xz
spneumo_pangenome_k32	0.2	greedytigs	11	na	ones	bzip	309056	2039753	548236	1491517	355860	172280	2039753	642692	550780	206159	756939	779032	spneumo_pangenome_k32.r_0.2.S_greedytigs.k_11.d_na.M_ones.C_bzip
spneumo_pangenome_k32	0.2	greedytigs	11	na	ones	xz	309056	2039753	548236	1491517	355860	172280	2039753	642692	550780	207480	758260	779032	spneumo_pangenome_k32.r_0.2.S_greedytigs.k_11.d_na.M_ones.C_xz
spneumo_pangenome_k32	0.2	greedytigs	11	na	runsapprox	bzip	309056	2039753	548236	1491517	355860	172280	2039753	642692	550780	206159	756939	779032	spneumo_pangenome_k32.r_0.2.S_greedytigs.k_11.d_na.M_runsapprox.C_bzip
spneumo_pangenome_k32	0.2	greedytigs	11	na	runsapprox	xz	309056	2039753	548236	1491517	355860	172280	2039753	642692	550780	207480	758260	779032	spneumo_pangenome_k32.r_0.2.S_greedytigs.k_11.d_na.M_runsapprox.C_xz
spneumo_pangenome_k32	0.3	greedytigs	11	na	default	bzip	463584	2469544	529484	1940060	194006	194006	2469544	772424	660984	81336	742320	842428	spneumo_pangenome_k32.r_0.3.S_greedytigs.k_11.d_na.M_default.C_bzip
spneumo_pangenome_k32	0.3	greedytigs	11	na	default	xz	463584	2469544	529484	1940060	194006	194006	2469544	772424	660984	97480	758464	842428	spneumo_pangenome_k32.r_0.3.S_greedytigs.k_11.d_na.M_default.C_xz
spneumo_pangenome_k32	0.3	greedytigs	11	na	ones	bzip	463584	2469544	917175	1552369	470222	194006	2469544	772424	660984	310101	971085	967768	spneumo_pangenome_k32.r_0.3.S_greedytigs.k_11.d_na.M_ones.C_bzip
spneumo_pangenome_k32	0.3	greedytigs	11	na	ones	xz	463584	2469544	917175	1552369	470222	194006	2469544	772424	660984	289308	950292	967768	spneumo_pangenome_k32.r_0.3.S_greedytigs.k_11.d_na.M_ones.C_xz
spneumo_pangenome_k32	0.3	greedytigs	11	na	runsapprox	bzip	463584	2469544	917175	1552369	470222	194006	2469544	772424	660984	310101	971085	967768	spneumo_pangenome_k32.r_0.3.S_greedytigs.k_11.d_na.M_runsapprox.C_bzip
spneumo_pangenome_k32	0.3	greedytigs	11	na	runsapprox	xz	463584	2469544	917175	1552369	470222	194006	2469544	772424	660984	289308	950292	967768	spneumo_pangenome_k32.r_0.3.S_greedytigs.k_11.d_na.M_runsapprox.C_xz
spneumo_pangenome_k32	0.4	greedytigs	11	na	default	bzip	618112	2649821	906671	1743150	174315	174315	2649821	814924	708252	99259	807511	904572	spneumo_pangenome_k32.r_0.4.S_greedytigs.k_11.d_na.M_default.C_bzip
spneumo_pangenome_k32	0.4	greedytigs	11	na	default	xz	618112	2649821	906671	1743150	174315	174315	2649821	814924	708252	113112	821364	904572	spneumo_pangenome_k32.r_0.4.S_greedytigs.k_11.d_na.M_default.C_xz
spneumo_pangenome_k32	0.4	greedytigs	11	na	ones	bzip	618112	2649821	1352410	1297411	462643	174315	2649821	814924	708252	335579	1043831	1037304	spneumo_pangenome_k32.r_0.4.S_greedytigs.k_11.d_na.M_ones.C_bzip
spneumo_pangenome_k32	0.4	greedytigs	11	na	ones	xz	618112	2649821	1352410	1297411	462643	174315	2649821	814924	708252	309152	1017404	1037304	spneumo_pangenome_k32.r_0.4.S_greedytigs.k_11.d_na.M_ones.C_xz
spneumo_pangenome_k32	0.4	greedytigs	11	na	runsapprox	bzip	618112	2649821	1352410	1297411	462643	174315	2649821	814924	708252	335579	1043831	1037304	spneumo_pangenome_k32.r_0.4.S_greedytigs.k_11.d_na.M_runsapprox.C_bzip
spneumo_pangenome_k32	0.4	greedytigs	11	na	runsapprox	xz	618112	2649821	1352410	1297411	462643	174315	2649821	814924	708252	309152	1017404	1037304	spneumo_pangenome_k32.r_0.4.S_greedytigs.k_11.d_na.M_runsapprox.C_xz
spneumo_pangenome_k32	0.5	greedytigs	11	na	default	bzip	772641	2617301	1350161	1267140	126714	126714	2617301	781064	696176	89813	785989	865792	spneumo_pangenome_k32.r_0.5.S_greedytigs.k_11.d_na.M_default.C_bzip
spneumo_pangenome_k32	0.5	greedytigs	11	na	default	xz	772641	2617301	1350161	1267140	126714	126714	2617301	781064	696176	109516	805692	865792	spneumo_pangenome_k32.r_0.5.S_greedytigs.k_11.d_na.M_default.C_xz
spneumo_pangenome_k32	0.5	greedytigs	11	na	ones	bzip	772641	2617301	1725903	891398	352631	126714	2617301	781064	696176	271600	967776	986132	spneumo_pangenome_k32.r_0.5.S_greedytigs.k_11.d_na.M_ones.C_bzip
spneumo_pangenome_k32	0.5	greedytigs	11	na	ones	xz	772641	2617301	1725903	891398	352631	126714	2617301	781064	696176	264780	960956	986132	spneumo_pangenome_k32.r_0.5.S_greedytigs.k_11.d_na.M_ones.C_xz
spneumo_pangenome_k32	0.5	greedytigs	11	na	runsapprox	bzip	772641	2617301	1725903	891398	352631	126714	2617301	781064	696176	271600	967776	986132	spneumo_pangenome_k32.r_0.5.S_greedytigs.k_11.d_na.M_runsapprox.C_bzip
spneumo_pangenome_k32	0.5	greedytigs	11	na	runsapprox	xz	772641	2617301	1725903	891398	352631	126714	2617301	781064	696176	264780	960956	986132	spneumo_pangenome_k32.r_0.5.S_greedytigs.k_11.d_na.M_runsapprox.C_xz
spneumo_pangenome_k32	0.6	greedytigs	11	na	default	bzip	927169	2457446	1654986	802460	80246	80246	2457446	714344	652532	66452	718984	776356	spneumo_pangenome_k32.r_0.6.S_greedytigs.k_11.d_na.M_default.C_bzip
spneumo_pangenome_k32	0.6	greedytigs	11	na	default	xz	927169	2457446	1654986	802460	80246	80246	2457446	714344	652532	91672	744204	776356	spneumo_pangenome_k32.r_0.6.S_greedytigs.k_11.d_na.M_default.C_xz
spneumo_pangenome_k32	0.6	greedytigs	11	na	ones	bzip	927169	2457446	1916656	540790	225985	80246	2457446	714344	652532	184141	836673	868632	spneumo_pangenome_k32.r_0.6.S_greedytigs.k_11.d_na.M_ones.C_bzip
spneumo_pangenome_k32	0.6	greedytigs	11	na	ones	xz	927169	2457446	1916656	540790	225985	80246	2457446	714344	652532	197468	850000	868632	spneumo_pangenome_k32.r_0.6.S_greedytigs.k_11.d_na.M_ones.C_xz
spneumo_pangenome_k32	0.6	greedytigs	11	na	runsapprox	bzip	927169	2457446	1916656	540790	225985	80246	2457446	714344	652532	184141	836673	868632	spneumo_pangenome_k32.r_0.6.S_greedytigs.k_11.d_na.M_runsapprox.C_bzip
spneumo_pangenome_k32	0.6	greedytigs	11	na	runsapprox	xz	927169	2457446	1916656	540790	225985	80246	2457446	714344	652532	197468	850000	868632	spneumo_pangenome_k32.r_0.6.S_greedytigs.k_11.d_na.M_runsapprox.C_xz
spneumo_pangenome_k32	0.7	greedytigs	11	na	default	bzip	1081697	2277846	1816456	461390	46139	46139	2277846	648404	612444	43496	655940	690744	spneumo_pangenome_k32.r_0.7.S_greedytigs.k_11.d_na.M_default.C_bzip
spneumo_pangenome_k32	0.7	greedytigs	11	na	default	xz	1081697	2277846	1816456	461390	46139	46139	2277846	648404	612444	68656	681100	690744	spneumo_pangenome_k32.r_0.7.S_greedytigs.k_11.d_na.M_default.C_xz
spneumo_pangenome_k32	0.7	greedytigs	11	na	ones	bzip	1081697	2277846	1974273	303573	127771	46139	2277846	648404	612444	109843	722287	731540	spneumo_pangenome_k32.r_0.7.S_greedytigs.k_11.d_na.M_ones.C_bzip
spneumo_pangenome_k32	0.7	greedytigs	11	na	ones	xz	1081697	2277846	1974273	303573	127771	46139	2277846	648404	612444	131140	743584	731540	spneumo_pangenome_k32.r_0.7.S_greedytigs.k_11.d_na.M_ones.C_xz
spneumo_pangenome_k32	0.7	greedytigs	11	na	runsapprox	bzip	1081697	2277846	1974273	303573	127771	46139	2277846	648404	612444	109843	722287	731540	spneumo_pangenome_k32.r_0.7.S_greedytigs.k_11.d_na.M_runsapprox.C_bzip
spneumo_pangenome_k32	0.7	greedytigs	11	na	runsapprox	xz	1081697	2277846	1974273	303573	127771	46139	2277846	648404	612444	131140	743584	731540	spneumo_pangenome_k32.r_0.7.S_greedytigs.k_11.d_na.M_runsapprox.C_xz
spneumo_pangenome_k32	0.8	greedytigs	11	na	default	bzip	1236225	2121370	1882200	239170	23917	23917	2121370	593364	569608	25659	595267	616924	spneumo_pangenome_k32.r_0.8.S_greedytigs.k_11.d_na.M_default.C_bzip
spneumo_pangenome_k32	0.8	greedytigs	11	na	default	xz	1236225	2121370	1882200	239170	23917	23917	2121370	593364	569608	46492	616100	616924	spneumo_pangenome_k32.r_0.8.S_greedytigs.k_11.d_na.M_default.C_xz
spneumo_pangenome_k32	0.8	greedytigs	11	na	ones	bzip	1236225	2121370	1966356	155014	64678	23917	2121370	593364	569608	59896	629504	637140	spneumo_pangenome_k32.r_0.8.S_greedytigs.k_11.d_na.M_ones.C_bzip
spneumo_pangenome_k32	0.8	greedytigs	11	na	ones	xz	1236225	2121370	1966356	155014	64678	23917	2121370	593364	569608	78000	647608	637140	spneumo_pangenome_k32.r_0.8.S_greedytigs.k_11.d_na.M_ones.C_xz
spneumo_pangenome_k32	0.8	greedytigs	11	na	runsapprox	bzip	1236225	2121370	1966356	155014	64678	23917	2121370	593364	569608	59896	629504	637140	spneumo_pangenome_k32.r_0.8.S_greedytigs.k_11.d_na.M_runsapprox.C_bzip
spneumo_pangenome_k32	0.8	greedytigs	11	na	runsapprox	xz	1236225	2121370	1966356	155014	64678	23917	2121370	593364	569608	78000	647608	637140	spneumo_pangenome_k32.r_0.8.S_greedytigs.k_11.d_na.M_runsapprox.C_xz
spneumo_pangenome_k32	0.9	greedytigs	11	na	default	bzip	1390753	1995210	1902410	92800	9280	9280	1995210	545620	534424	11765	546189	555728	spneumo_pangenome_k32.r_0.9.S_greedytigs.k_11.d_na.M_default.C_bzip
spneumo_pangenome_k32	0.9	greedytigs	11	na	default	xz	1390753	1995210	1902410	92800	9280	9280	1995210	545620	534424	24648	559072	555728	spneumo_pangenome_k32.r_0.9.S_greedytigs.k_11.d_na.M_default.C_xz
spneumo_pangenome_k32	0.9	greedytigs	11	na	ones	bzip	1390753	1995210	1935276	59934	24192	9280	1995210	545620	534424	25344	559768	563096	spneumo_pangenome_k32.r_0.9.S_greedytigs.k_11.d_na.M_ones.C_bzip
spneumo_pangenome_k32	0.9	greedytigs	11	na	ones	xz	1390753	1995210	1935276	59934	24192	9280	1995210	545620	534424	36276	570700	563096	spneumo_pangenome_k32.r_0.9.S_greedytigs.k_11.d_na.M_ones.C_xz
spneumo_pangenome_k32	0.9	greedytigs	11	na	runsapprox	bzip	1390753	1995210	1935276	59934	24192	9280	1995210	545620	534424	25344	559768	563096	spneumo_pangenome_k32.r_0.9.S_greedytigs.k_11.d_na.M_runsapprox.C_bzip
spneumo_pangenome_k32	0.9	greedytigs	11	na	runsapprox	xz	1390753	1995210	1935276	59934	24192	9280	1995210	545620	534424	36276	570700	563096	spneumo_pangenome_k32.r_0.9.S_greedytigs.k_11.d_na.M_runsapprox.C_xz
spneumo_pangenome_k32	1.0	greedytigs	11	na	default	bzip	1545282	1860602	1852872	7730	773	773	1860602	508368	508412	1795	510207	506504	spneumo_pangenome_k32.r_1.0.S_greedytigs.k_11.d_na.M_default.C_bzip
spneumo_pangenome_k32	1.0	greedytigs	11	na	default	xz	1545282	1860602	1852872	7730	773	773	1860602	508368	508412	3396	511808	506504	spneumo_pangenome_k32.r_1.0.S_greedytigs.k_11.d_na.M_default.C_xz
spneumo_pangenome_k32	1.0	greedytigs	11	na	ones	bzip	1545282	1860602	1855209	5393	1717	773	1860602	508368	508412	3093	511505	509852	spneumo_pangenome_k32.r_1.0.S_greedytigs.k_11.d_na.M_ones.C_bzip
spneumo_pangenome_k32	1.0	greedytigs	11	na	ones	xz	1545282	1860602	1855209	5393	1717	773	1860602	508368	508412	4448	512860	509852	spneumo_pangenome_k32.r_1.0.S_greedytigs.k_11.d_na.M_ones.C_xz
spneumo_pangenome_k32	1.0	greedytigs	11	na	runsapprox	bzip	1545282	1860602	1853407	7195	773	773	1860602	508368	508412	2054	510466	510312	spneumo_pangenome_k32.r_1.0.S_greedytigs.k_11.d_na.M_runsapprox.C_bzip
spneumo_pangenome_k32	1.0	greedytigs	11	na	runsapprox	xz	1545282	1860602	1853407	7195	773	773	1860602	508368	508412	3504	511916	510312	spneumo_pangenome_k32.r_1.0.S_greedytigs.k_11.d_na.M_runsapprox.C_xz
spneumo_pangenome_k32	0.000000001	matchtigs	11	na	default	bzip	1	11	1	10	1	1	11	76	76	41	117	76	spneumo_pangenome_k32.r_0.000000001.S_matchtigs.k_11.d_na.M_default.C_bzip
spneumo_pangenome_k32	0.000000001	matchtigs	11	na	default	xz	1	11	1	10	1	1	11	76	76	76	152	76	spneumo_pangenome_k32.r_0.000000001.S_matchtigs.k_11.d_na.M_default.C_xz
spneumo_pangenome_k32	0.000000001	matchtigs	11	na	ones	bzip	1	11	1	10	1	1	11	76	76	41	117	76	spneumo_pangenome_k32.r_0.000000001.S_matchtigs.k_11.d_na.M_ones.C_bzip
spneumo_pangenome_k32	0.000000001	matchtigs	11	na	ones	xz	1	11	1	10	1	1	11	76	76	76	152	76	spneumo_pangenome_k32.r_0.000000001.S_matchtigs.k_11.d_na.M_ones.C_xz
spneumo_pangenome_k32	0.000000001	matchtigs	11	na	runsapprox	bzip	1	11	1	10	1	1	11	76	76	41	117	76	spneumo_pangenome_k32.r_0.000000001.S_matchtigs.k_11.d_na.M_runsapprox.C_bzip
spneumo_pangenome_k32	0.000000001	matchtigs	11	na	runsapprox	xz	1	11	1	10	1	1	11	76	76	76	152	76	spneumo_pangenome_k32.r_0.000000001.S_matchtigs.k_11.d_na.M_runsapprox.C_xz
spneumo_pangenome_k32	0.0001	matchtigs	11	na	default	bzip	154	1694	154	1540	154	154	1694	772	688	46	734	768	spneumo_pangenome_k32.r_0.0001.S_matchtigs.k_11.d_na.M_default.C_bzip
spneumo_pangenome_k32	0.0001	matchtigs	11	na	default	xz	154	1694	154	1540	154	154	1694	772	688	92	780	768	spneumo_pangenome_k32.r_0.0001.S_matchtigs.k_11.d_na.M_default.C_xz
spneumo_pangenome_k32	0.0001	matchtigs	11	na	ones	bzip	154	1694	154	1540	154	154	1694	772	688	46	734	768	spneumo_pangenome_k32.r_0.0001.S_matchtigs.k_11.d_na.M_ones.C_bzip
spneumo_pangenome_k32	0.0001	matchtigs	11	na	ones	xz	154	1694	154	1540	154	154	1694	772	688	92	780	768	spneumo_pangenome_k32.r_0.0001.S_matchtigs.k_11.d_na.M_ones.C_xz
spneumo_pangenome_k32	0.0001	matchtigs	11	na	runsapprox	bzip	154	1694	154	1540	154	154	1694	772	688	46	734	768	spneumo_pangenome_k32.r_0.0001.S_matchtigs.k_11.d_na.M_runsapprox.C_bzip
spneumo_pangenome_k32	0.0001	matchtigs	11	na	runsapprox	xz	154	1694	154	1540	154	154	1694	772	688	92	780	768	spneumo_pangenome_k32.r_0.0001.S_matchtigs.k_11.d_na.M_runsapprox.C_xz
spneumo_pangenome_k32	0.001	matchtigs	11	na	default	bzip	1545	16965	1545	15420	1542	1542	16965	5008	4640	51	4691	5048	spneumo_pangenome_k32.r_0.001.S_matchtigs.k_11.d_na.M_default.C_bzip
spneumo_pangenome_k32	0.001	matchtigs	11	na	default	xz	1545	16965	1545	15420	1542	1542	16965	5008	4640	144	4784	5048	spneumo_pangenome_k32.r_0.001.S_matchtigs.k_11.d_na.M_default.C_xz
spneumo_pangenome_k32	0.001	matchtigs	11	na	ones	bzip	1545	16965	1553	15412	1549	1542	16965	5008	4640	80	4720	5048	spneumo_pangenome_k32.r_0.001.S_matchtigs.k_11.d_na.M_ones.C_bzip
spneumo_pangenome_k32	0.001	matchtigs	11	na	ones	xz	1545	16965	1553	15412	1549	1542	16965	5008	4640	172	4812	5048	spneumo_pangenome_k32.r_0.001.S_matchtigs.k_11.d_na.M_ones.C_xz
spneumo_pangenome_k32	0.001	matchtigs	11	na	runsapprox	bzip	1545	16965	1553	15412	1549	1542	16965	5008	4640	80	4720	5048	spneumo_pangenome_k32.r_0.001.S_matchtigs.k_11.d_na.M_runsapprox.C_bzip
spneumo_pangenome_k32	0.001	matchtigs	11	na	runsapprox	xz	1545	16965	1553	15412	1549	1542	16965	5008	4640	172	4812	5048	spneumo_pangenome_k32.r_0.001.S_matchtigs.k_11.d_na.M_runsapprox.C_xz
spneumo_pangenome_k32	0.01	matchtigs	11	na	default	bzip	15452	164822	15452	149370	14937	14937	164822	48672	43744	760	44504	49824	spneumo_pangenome_k32.r_0.01.S_matchtigs.k_11.d_na.M_default.C_bzip
spneumo_pangenome_k32	0.01	matchtigs	11	na	default	xz	15452	164822	15452	149370	14937	14937	164822	48672	43744	1320	45064	49824	spneumo_pangenome_k32.r_0.01.S_matchtigs.k_11.d_na.M_default.C_xz
spneumo_pangenome_k32	0.01	matchtigs	11	na	ones	bzip	15452	164822	16444	148378	15921	14937	164822	48672	43744	2196	45940	50788	spneumo_pangenome_k32.r_0.01.S_matchtigs.k_11.d_na.M_ones.C_bzip
spneumo_pangenome_k32	0.01	matchtigs	11	na	ones	xz	15452	164822	16444	148378	15921	14937	164822	48672	43744	3432	47176	50788	spneumo_pangenome_k32.r_0.01.S_matchtigs.k_11.d_na.M_ones.C_xz
spneumo_pangenome_k32	0.01	matchtigs	11	na	runsapprox	bzip	15452	164822	16444	148378	15921	14937	164822	48672	43744	2196	45940	50788	spneumo_pangenome_k32.r_0.01.S_matchtigs.k_11.d_na.M_runsapprox.C_bzip
spneumo_pangenome_k32	0.01	matchtigs	11	na	runsapprox	xz	15452	164822	16444	148378	15921	14937	164822	48672	43744	3432	47176	50788	spneumo_pangenome_k32.r_0.01.S_matchtigs.k_11.d_na.M_runsapprox.C_xz
spneumo_pangenome_k32	0.4	matchtigs	11	na	default	bzip	618112	2586214	803994	1782220	178222	178222	2586214	802528	694380	96333	790713	885756	spneumo_pangenome_k32.r_0.4.S_matchtigs.k_11.d_na.M_default.C_bzip
spneumo_pangenome_k32	0.4	matchtigs	11	na	default	xz	618112	2586214	803994	1782220	178222	178222	2586214	802528	694380	110604	804984	885756	spneumo_pangenome_k32.r_0.4.S_matchtigs.k_11.d_na.M_default.C_xz
spneumo_pangenome_k32	0.4	matchtigs	11	na	ones	bzip	618112	2586214	1264127	1322087	474441	178222	2586214	802528	694380	339449	1033829	1018984	spneumo_pangenome_k32.r_0.4.S_matchtigs.k_11.d_na.M_ones.C_bzip
spneumo_pangenome_k32	0.4	matchtigs	11	na	ones	xz	618112	2586214	1264127	1322087	474441	178222	2586214	802528	694380	309468	1003848	1018984	spneumo_pangenome_k32.r_0.4.S_matchtigs.k_11.d_na.M_ones.C_xz
spneumo_pangenome_k32	0.4	matchtigs	11	na	runsapprox	bzip	618112	2586214	1264127	1322087	474441	178222	2586214	802528	694380	339449	1033829	1018984	spneumo_pangenome_k32.r_0.4.S_matchtigs.k_11.d_na.M_runsapprox.C_bzip
spneumo_pangenome_k32	0.4	matchtigs	11	na	runsapprox	xz	618112	2586214	1264127	1322087	474441	178222	2586214	802528	694380	309468	1003848	1018984	spneumo_pangenome_k32.r_0.4.S_matchtigs.k_11.d_na.M_runsapprox.C_xz
spneumo_pangenome_k32	0.000000001	prophasm	11	na	default	bzip	1	11	1	10	1	1	11	76	76	41	117	76	spneumo_pangenome_k32.r_0.000000001.S_prophasm.k_11.d_na.M_default.C_bzip
spneumo_pangenome_k32	0.000000001	prophasm	11	na	default	xz	1	11	1	10	1	1	11	76	76	76	152	76	spneumo_pangenome_k32.r_0.000000001.S_prophasm.k_11.d_na.M_default.C_xz
spneumo_pangenome_k32	0.000000001	prophasm	11	na	ones	bzip	1	11	1	10	1	1	11	76	76	41	117	76	spneumo_pangenome_k32.r_0.000000001.S_prophasm.k_11.d_na.M_ones.C_bzip
spneumo_pangenome_k32	0.000000001	prophasm	11	na	ones	xz	1	11	1	10	1	1	11	76	76	76	152	76	spneumo_pangenome_k32.r_0.000000001.S_prophasm.k_11.d_na.M_ones.C_xz
spneumo_pangenome_k32	0.000000001	prophasm	11	na	runsapprox	bzip	1	11	1	10	1	1	11	76	76	41	117	76	spneumo_pangenome_k32.r_0.000000001.S_prophasm.k_11.d_na.M_runsapprox.C_bzip
spneumo_pangenome_k32	0.000000001	prophasm	11	na	runsapprox	xz	1	11	1	10	1	1	11	76	76	76	152	76	spneumo_pangenome_k32.r_0.000000001.S_prophasm.k_11.d_na.M_runsapprox.C_xz
spneumo_pangenome_k32	0.0001	prophasm	11	na	default	bzip	154	1694	154	1540	154	154	1694	800	696	46	742	812	spneumo_pangenome_k32.r_0.0001.S_prophasm.k_11.d_na.M_default.C_bzip
spneumo_pangenome_k32	0.0001	prophasm	11	na	default	xz	154	1694	154	1540	154	154	1694	800	696	92	788	812	spneumo_pangenome_k32.r_0.0001.S_prophasm.k_11.d_na.M_default.C_xz
spneumo_pangenome_k32	0.0001	prophasm	11	na	ones	bzip	154	1694	154	1540	154	154	1694	800	696	46	742	812	spneumo_pangenome_k32.r_0.0001.S_prophasm.k_11.d_na.M_ones.C_bzip
spneumo_pangenome_k32	0.0001	prophasm	11	na	ones	xz	154	1694	154	1540	154	154	1694	800	696	92	788	812	spneumo_pangenome_k32.r_0.0001.S_prophasm.k_11.d_na.M_ones.C_xz
spneumo_pangenome_k32	0.0001	prophasm	11	na	runsapprox	bzip	154	1694	154	1540	154	154	1694	800	696	46	742	812	spneumo_pangenome_k32.r_0.0001.S_prophasm.k_11.d_na.M_runsapprox.C_bzip
spneumo_pangenome_k32	0.0001	prophasm	11	na	runsapprox	xz	154	1694	154	1540	154	154	1694	800	696	92	788	812	spneumo_pangenome_k32.r_0.0001.S_prophasm.k_11.d_na.M_runsapprox.C_xz
spneumo_pangenome_k32	0.001	prophasm	11	na	default	bzip	1545	16965	1545	15420	1542	1542	16965	5856	5084	50	5134	6060	spneumo_pangenome_k32.r_0.001.S_prophasm.k_11.d_na.M_default.C_bzip
spneumo_pangenome_k32	0.001	prophasm	11	na	default	xz	1545	16965	1545	15420	1542	1542	16965	5856	5084	140	5224	6060	spneumo_pangenome_k32.r_0.001.S_prophasm.k_11.d_na.M_default.C_xz
spneumo_pangenome_k32	0.001	prophasm	11	na	ones	bzip	1545	16965	1563	15402	1560	1542	16965	5856	5084	105	5189	6068	spneumo_pangenome_k32.r_0.001.S_prophasm.k_11.d_na.M_ones.C_bzip
spneumo_pangenome_k32	0.001	prophasm	11	na	ones	xz	1545	16965	1563	15402	1560	1542	16965	5856	5084	212	5296	6068	spneumo_pangenome_k32.r_0.001.S_prophasm.k_11.d_na.M_ones.C_xz
spneumo_pangenome_k32	0.001	prophasm	11	na	runsapprox	bzip	1545	16965	1563	15402	1560	1542	16965	5856	5084	105	5189	6068	spneumo_pangenome_k32.r_0.001.S_prophasm.k_11.d_na.M_runsapprox.C_bzip
spneumo_pangenome_k32	0.001	prophasm	11	na	runsapprox	xz	1545	16965	1563	15402	1560	1542	16965	5856	5084	212	5296	6068	spneumo_pangenome_k32.r_0.001.S_prophasm.k_11.d_na.M_runsapprox.C_xz
spneumo_pangenome_k32	0.01	prophasm	11	na	default	bzip	15452	164822	15452	149370	14937	14937	164822	53396	45824	734	46558	54488	spneumo_pangenome_k32.r_0.01.S_prophasm.k_11.d_na.M_default.C_bzip
spneumo_pangenome_k32	0.01	prophasm	11	na	default	xz	15452	164822	15452	149370	14937	14937	164822	53396	45824	1232	47056	54488	spneumo_pangenome_k32.r_0.01.S_prophasm.k_11.d_na.M_default.C_xz
spneumo_pangenome_k32	0.01	prophasm	11	na	ones	bzip	15452	164822	16422	148400	15889	14937	164822	53396	45824	2194	48018	55132	spneumo_pangenome_k32.r_0.01.S_prophasm.k_11.d_na.M_ones.C_bzip
spneumo_pangenome_k32	0.01	prophasm	11	na	ones	xz	15452	164822	16422	148400	15889	14937	164822	53396	45824	3400	49224	55132	spneumo_pangenome_k32.r_0.01.S_prophasm.k_11.d_na.M_ones.C_xz
spneumo_pangenome_k32	0.01	prophasm	11	na	runsapprox	bzip	15452	164822	16422	148400	15889	14937	164822	53396	45824	2194	48018	55132	spneumo_pangenome_k32.r_0.01.S_prophasm.k_11.d_na.M_runsapprox.C_bzip
spneumo_pangenome_k32	0.01	prophasm	11	na	runsapprox	xz	15452	164822	16422	148400	15889	14937	164822	53396	45824	3400	49224	55132	spneumo_pangenome_k32.r_0.01.S_prophasm.k_11.d_na.M_runsapprox.C_xz
spneumo_pangenome_k32	0.05	prophasm	11	na	default	bzip	77264	735414	77264	658150	65815	65815	735414	233876	199432	8221	207653	234516	spneumo_pangenome_k32.r_0.05.S_prophasm.k_11.d_na.M_default.C_bzip
spneumo_pangenome_k32	0.05	prophasm	11	na	default	xz	77264	735414	77264	658150	65815	65815	735414	233876	199432	12028	211460	234516	spneumo_pangenome_k32.r_0.05.S_prophasm.k_11.d_na.M_default.C_xz
spneumo_pangenome_k32	0.05	prophasm	11	na	ones	bzip	77264	735414	98960	636454	86284	65815	735414	233876	199432	29719	229151	253172	spneumo_pangenome_k32.r_0.05.S_prophasm.k_11.d_na.M_ones.C_bzip
spneumo_pangenome_k32	0.05	prophasm	11	na	ones	xz	77264	735414	98960	636454	86284	65815	735414	233876	199432	36072	235504	253172	spneumo_pangenome_k32.r_0.05.S_prophasm.k_11.d_na.M_ones.C_xz
spneumo_pangenome_k32	0.05	prophasm	11	na	runsapprox	bzip	77264	735414	98960	636454	86284	65815	735414	233876	199432	29719	229151	253172	spneumo_pangenome_k32.r_0.05.S_prophasm.k_11.d_na.M_runsapprox.C_bzip
spneumo_pangenome_k32	0.05	prophasm	11	na	runsapprox	xz	77264	735414	98960	636454	86284	65815	735414	233876	199432	36072	235504	253172	spneumo_pangenome_k32.r_0.05.S_prophasm.k_11.d_na.M_runsapprox.C_xz
spneumo_pangenome_k32	0.1	prophasm	11	na	default	bzip	154528	1289118	154528	1134590	113459	113459	1289118	411808	350928	20999	371927	424232	spneumo_pangenome_k32.r_0.1.S_prophasm.k_11.d_na.M_default.C_bzip
spneumo_pangenome_k32	0.1	prophasm	11	na	default	xz	154528	1289118	154528	1134590	113459	113459	1289118	411808	350928	28996	379924	424232	spneumo_pangenome_k32.r_0.1.S_prophasm.k_11.d_na.M_default.C_xz
spneumo_pangenome_k32	0.1	prophasm	11	na	ones	bzip	154528	1289118	230663	1058455	181189	113459	1289118	411808	350928	82437	433365	464224	spneumo_pangenome_k32.r_0.1.S_prophasm.k_11.d_na.M_ones.C_bzip
spneumo_pangenome_k32	0.1	prophasm	11	na	ones	xz	154528	1289118	230663	1058455	181189	113459	1289118	411808	350928	91596	442524	464224	spneumo_pangenome_k32.r_0.1.S_prophasm.k_11.d_na.M_ones.C_xz
spneumo_pangenome_k32	0.1	prophasm	11	na	runsapprox	bzip	154528	1289118	230663	1058455	181189	113459	1289118	411808	350928	82437	433365	464224	spneumo_pangenome_k32.r_0.1.S_prophasm.k_11.d_na.M_runsapprox.C_bzip
spneumo_pangenome_k32	0.1	prophasm	11	na	runsapprox	xz	154528	1289118	230663	1058455	181189	113459	1289118	411808	350928	91596	442524	464224	spneumo_pangenome_k32.r_0.1.S_prophasm.k_11.d_na.M_runsapprox.C_xz
spneumo_pangenome_k32	0.2	prophasm	11	na	default	bzip	309056	2069406	309056	1760350	176035	176035	2069406	651220	553956	46155	600111	687324	spneumo_pangenome_k32.r_0.2.S_prophasm.k_11.d_na.M_default.C_bzip
spneumo_pangenome_k32	0.2	prophasm	11	na	default	xz	309056	2069406	309056	1760350	176035	176035	2069406	651220	553956	58480	612436	687324	spneumo_pangenome_k32.r_0.2.S_prophasm.k_11.d_na.M_default.C_xz
spneumo_pangenome_k32	0.2	prophasm	11	na	ones	bzip	309056	2069406	549662	1519744	364724	176035	2069406	651220	553956	205146	759102	785056	spneumo_pangenome_k32.r_0.2.S_prophasm.k_11.d_na.M_ones.C_bzip
spneumo_pangenome_k32	0.2	prophasm	11	na	ones	xz	309056	2069406	549662	1519744	364724	176035	2069406	651220	553956	207536	761492	785056	spneumo_pangenome_k32.r_0.2.S_prophasm.k_11.d_na.M_ones.C_xz
spneumo_pangenome_k32	0.2	prophasm	11	na	runsapprox	bzip	309056	2069406	549662	1519744	364724	176035	2069406	651220	553956	205146	759102	785056	spneumo_pangenome_k32.r_0.2.S_prophasm.k_11.d_na.M_runsapprox.C_bzip
spneumo_pangenome_k32	0.2	prophasm	11	na	runsapprox	xz	309056	2069406	549662	1519744	364724	176035	2069406	651220	553956	207536	761492	785056	spneumo_pangenome_k32.r_0.2.S_prophasm.k_11.d_na.M_runsapprox.C_xz
spneumo_pangenome_k32	0.3	prophasm	11	na	default	bzip	463584	2590004	463584	2126420	212642	212642	2590004	813640	698544	65632	764176	864224	spneumo_pangenome_k32.r_0.3.S_prophasm.k_11.d_na.M_default.C_bzip
spneumo_pangenome_k32	0.3	prophasm	11	na	default	xz	463584	2590004	463584	2126420	212642	212642	2590004	813640	698544	80532	779076	864224	spneumo_pangenome_k32.r_0.3.S_prophasm.k_11.d_na.M_default.C_xz
spneumo_pangenome_k32	0.3	prophasm	11	na	ones	bzip	463584	2590004	906561	1683443	516789	212642	2590004	813640	698544	321993	1020537	1008708	spneumo_pangenome_k32.r_0.3.S_prophasm.k_11.d_na.M_ones.C_bzip
spneumo_pangenome_k32	0.3	prophasm	11	na	ones	xz	463584	2590004	906561	1683443	516789	212642	2590004	813640	698544	302936	1001480	1008708	spneumo_pangenome_k32.r_0.3.S_prophasm.k_11.d_na.M_ones.C_xz
spneumo_pangenome_k32	0.3	prophasm	11	na	runsapprox	bzip	463584	2590004	906561	1683443	516789	212642	2590004	813640	698544	321993	1020537	1008708	spneumo_pangenome_k32.r_0.3.S_prophasm.k_11.d_na.M_runsapprox.C_bzip
spneumo_pangenome_k32	0.3	prophasm	11	na	runsapprox	xz	463584	2590004	906561	1683443	516789	212642	2590004	813640	698544	302936	1001480	1008708	spneumo_pangenome_k32.r_0.3.S_prophasm.k_11.d_na.M_runsapprox.C_xz
spneumo_pangenome_k32	0.4	prophasm	11	na	default	bzip	618112	2951292	618112	2333180	233318	233318	2951292	920296	795776	79213	874989	985732	spneumo_pangenome_k32.r_0.4.S_prophasm.k_11.d_na.M_default.C_bzip
spneumo_pangenome_k32	0.4	prophasm	11	na	default	xz	618112	2951292	618112	2333180	233318	233318	2951292	920296	795776	96384	892160	985732	spneumo_pangenome_k32.r_0.4.S_prophasm.k_11.d_na.M_default.C_xz
spneumo_pangenome_k32	0.4	prophasm	11	na	ones	bzip	618112	2951292	1275708	1675584	622304	233318	2951292	920296	795776	409434	1205210	1163728	spneumo_pangenome_k32.r_0.4.S_prophasm.k_11.d_na.M_ones.C_bzip
spneumo_pangenome_k32	0.4	prophasm	11	na	ones	xz	618112	2951292	1275708	1675584	622304	233318	2951292	920296	795776	367720	1163496	1163728	spneumo_pangenome_k32.r_0.4.S_prophasm.k_11.d_na.M_ones.C_xz
spneumo_pangenome_k32	0.4	prophasm	11	na	runsapprox	bzip	618112	2951292	1275708	1675584	622304	233318	2951292	920296	795776	409434	1205210	1163728	spneumo_pangenome_k32.r_0.4.S_prophasm.k_11.d_na.M_runsapprox.C_bzip
spneumo_pangenome_k32	0.4	prophasm	11	na	runsapprox	xz	618112	2951292	1275708	1675584	622304	233318	2951292	920296	795776	367720	1163496	1163728	spneumo_pangenome_k32.r_0.4.S_prophasm.k_11.d_na.M_runsapprox.C_xz
spneumo_pangenome_k32	0.5	prophasm	11	na	default	bzip	772641	3200091	772641	2427450	242745	242745	3200091	995400	863708	88105	951813	1068540	spneumo_pangenome_k32.r_0.5.S_prophasm.k_11.d_na.M_default.C_bzip
spneumo_pangenome_k32	0.5	prophasm	11	na	default	xz	772641	3200091	772641	2427450	242745	242745	3200091	995400	863708	107576	971284	1068540	spneumo_pangenome_k32.r_0.5.S_prophasm.k_11.d_na.M_default.C_xz
spneumo_pangenome_k32	0.5	prophasm	11	na	ones	bzip	772641	3200091	1637914	1562177	674700	242745	3200091	995400	863708	461794	1325502	1263656	spneumo_pangenome_k32.r_0.5.S_prophasm.k_11.d_na.M_ones.C_bzip
spneumo_pangenome_k32	0.5	prophasm	11	na	ones	xz	772641	3200091	1637914	1562177	674700	242745	3200091	995400	863708	403868	1267576	1263656	spneumo_pangenome_k32.r_0.5.S_prophasm.k_11.d_na.M_ones.C_xz
spneumo_pangenome_k32	0.5	prophasm	11	na	runsapprox	bzip	772641	3200091	1637914	1562177	674700	242745	3200091	995400	863708	461794	1325502	1263656	spneumo_pangenome_k32.r_0.5.S_prophasm.k_11.d_na.M_runsapprox.C_bzip
spneumo_pangenome_k32	0.5	prophasm	11	na	runsapprox	xz	772641	3200091	1637914	1562177	674700	242745	3200091	995400	863708	403868	1267576	1263656	spneumo_pangenome_k32.r_0.5.S_prophasm.k_11.d_na.M_runsapprox.C_xz
spneumo_pangenome_k32	0.6	prophasm	11	na	default	bzip	927169	3348759	927169	2421590	242159	242159	3348759	1043392	905924	93819	999743	1116364	spneumo_pangenome_k32.r_0.6.S_prophasm.k_11.d_na.M_default.C_bzip
spneumo_pangenome_k32	0.6	prophasm	11	na	default	xz	927169	3348759	927169	2421590	242159	242159	3348759	1043392	905924	115064	1020988	1116364	spneumo_pangenome_k32.r_0.6.S_prophasm.k_11.d_na.M_default.C_xz
spneumo_pangenome_k32	0.6	prophasm	11	na	ones	bzip	927169	3348759	1973207	1375552	671780	242159	3348759	1043392	905924	476857	1382781	1311580	spneumo_pangenome_k32.r_0.6.S_prophasm.k_11.d_na.M_ones.C_bzip
spneumo_pangenome_k32	0.6	prophasm	11	na	ones	xz	927169	3348759	1973207	1375552	671780	242159	3348759	1043392	905924	412736	1318660	1311580	spneumo_pangenome_k32.r_0.6.S_prophasm.k_11.d_na.M_ones.C_xz
spneumo_pangenome_k32	0.6	prophasm	11	na	runsapprox	bzip	927169	3348759	1973207	1375552	671780	242159	3348759	1043392	905924	476857	1382781	1311580	spneumo_pangenome_k32.r_0.6.S_prophasm.k_11.d_na.M_runsapprox.C_bzip
spneumo_pangenome_k32	0.6	prophasm	11	na	runsapprox	xz	927169	3348759	1973207	1375552	671780	242159	3348759	1043392	905924	412736	1318660	1311580	spneumo_pangenome_k32.r_0.6.S_prophasm.k_11.d_na.M_runsapprox.C_xz
spneumo_pangenome_k32	0.7	prophasm	11	na	default	bzip	1081697	3392127	1081697	2310430	231043	231043	3392127	1041444	905300	95566	1000866	1116264	spneumo_pangenome_k32.r_0.7.S_prophasm.k_11.d_na.M_default.C_bzip
spneumo_pangenome_k32	0.7	prophasm	11	na	default	xz	1081697	3392127	1081697	2310430	231043	231043	3392127	1041444	905300	118512	1023812	1116264	spneumo_pangenome_k32.r_0.7.S_prophasm.k_11.d_na.M_default.C_xz
spneumo_pangenome_k32	0.7	prophasm	11	na	ones	bzip	1081697	3392127	2255245	1136882	609851	231043	3392127	1041444	905300	452960	1358260	1302512	spneumo_pangenome_k32.r_0.7.S_prophasm.k_11.d_na.M_ones.C_bzip
spneumo_pangenome_k32	0.7	prophasm	11	na	ones	xz	1081697	3392127	2255245	1136882	609851	231043	3392127	1041444	905300	396432	1301732	1302512	spneumo_pangenome_k32.r_0.7.S_prophasm.k_11.d_na.M_ones.C_xz
spneumo_pangenome_k32	0.7	prophasm	11	na	runsapprox	bzip	1081697	3392127	2255245	1136882	609851	231043	3392127	1041444	905300	452960	1358260	1302512	spneumo_pangenome_k32.r_0.7.S_prophasm.k_11.d_na.M_runsapprox.C_bzip
spneumo_pangenome_k32	0.7	prophasm	11	na	runsapprox	xz	1081697	3392127	2255245	1136882	609851	231043	3392127	1041444	905300	396432	1301732	1302512	spneumo_pangenome_k32.r_0.7.S_prophasm.k_11.d_na.M_runsapprox.C_xz
spneumo_pangenome_k32	0.8	prophasm	11	na	default	bzip	1236225	3312925	1236225	2076700	207670	207670	3312925	1007632	882740	93174	975914	1078944	spneumo_pangenome_k32.r_0.8.S_prophasm.k_11.d_na.M_default.C_bzip
spneumo_pangenome_k32	0.8	prophasm	11	na	default	xz	1236225	3312925	1236225	2076700	207670	207670	3312925	1007632	882740	116964	999704	1078944	spneumo_pangenome_k32.r_0.8.S_prophasm.k_11.d_na.M_default.C_xz
spneumo_pangenome_k32	0.8	prophasm	11	na	ones	bzip	1236225	3312925	2449436	863489	493701	207670	3312925	1007632	882740	389465	1272205	1231636	spneumo_pangenome_k32.r_0.8.S_prophasm.k_11.d_na.M_ones.C_bzip
spneumo_pangenome_k32	0.8	prophasm	11	na	ones	xz	1236225	3312925	2449436	863489	493701	207670	3312925	1007632	882740	349452	1232192	1231636	spneumo_pangenome_k32.r_0.8.S_prophasm.k_11.d_na.M_ones.C_xz
spneumo_pangenome_k32	0.8	prophasm	11	na	runsapprox	bzip	1236225	3312925	2449436	863489	493701	207670	3312925	1007632	882740	389465	1272205	1231636	spneumo_pangenome_k32.r_0.8.S_prophasm.k_11.d_na.M_runsapprox.C_bzip
spneumo_pangenome_k32	0.8	prophasm	11	na	runsapprox	xz	1236225	3312925	2449436	863489	493701	207670	3312925	1007632	882740	349452	1232192	1231636	spneumo_pangenome_k32.r_0.8.S_prophasm.k_11.d_na.M_runsapprox.C_xz
spneumo_pangenome_k32	0.9	prophasm	11	na	default	bzip	1390753	3071723	1390753	1680970	168097	168097	3071723	918148	815388	84086	899474	981360	spneumo_pangenome_k32.r_0.9.S_prophasm.k_11.d_na.M_default.C_bzip
spneumo_pangenome_k32	0.9	prophasm	11	na	default	xz	1390753	3071723	1390753	1680970	168097	168097	3071723	918148	815388	108164	923552	981360	spneumo_pangenome_k32.r_0.9.S_prophasm.k_11.d_na.M_default.C_xz
spneumo_pangenome_k32	0.9	prophasm	11	na	ones	bzip	1390753	3071723	2487780	583943	340398	168097	3071723	918148	815388	293403	1108791	1083400	spneumo_pangenome_k32.r_0.9.S_prophasm.k_11.d_na.M_ones.C_bzip
spneumo_pangenome_k32	0.9	prophasm	11	na	ones	xz	1390753	3071723	2487780	583943	340398	168097	3071723	918148	815388	273224	1088612	1083400	spneumo_pangenome_k32.r_0.9.S_prophasm.k_11.d_na.M_ones.C_xz
spneumo_pangenome_k32	0.9	prophasm	11	na	runsapprox	bzip	1390753	3071723	2487780	583943	340398	168097	3071723	918148	815388	293403	1108791	1083400	spneumo_pangenome_k32.r_0.9.S_prophasm.k_11.d_na.M_runsapprox.C_bzip
spneumo_pangenome_k32	0.9	prophasm	11	na	runsapprox	xz	1390753	3071723	2487780	583943	340398	168097	3071723	918148	815388	273224	1088612	1083400	spneumo_pangenome_k32.r_0.9.S_prophasm.k_11.d_na.M_runsapprox.C_xz
spneumo_pangenome_k32	1.0	prophasm	11	na	default	bzip	1545282	2529792	1545282	984510	98451	98451	2529792	704208	635820	61106	696926	752712	spneumo_pangenome_k32.r_1.0.S_prophasm.k_11.d_na.M_default.C_bzip
spneumo_pangenome_k32	1.0	prophasm	11	na	default	xz	1545282	2529792	1545282	984510	98451	98451	2529792	704208	635820	81752	717572	752712	spneumo_pangenome_k32.r_1.0.S_prophasm.k_11.d_na.M_default.C_xz
spneumo_pangenome_k32	1.0	prophasm	11	na	ones	bzip	1545282	2529792	2201757	328035	170966	98451	2529792	704208	635820	172960	808780	796628	spneumo_pangenome_k32.r_1.0.S_prophasm.k_11.d_na.M_ones.C_bzip
spneumo_pangenome_k32	1.0	prophasm	11	na	ones	xz	1545282	2529792	2201757	328035	170966	98451	2529792	704208	635820	166276	802096	796628	spneumo_pangenome_k32.r_1.0.S_prophasm.k_11.d_na.M_ones.C_xz
spneumo_pangenome_k32	1.0	prophasm	11	na	runsapprox	bzip	1545282	2529792	2201757	328035	170966	98451	2529792	704208	635820	172960	808780	796628	spneumo_pangenome_k32.r_1.0.S_prophasm.k_11.d_na.M_runsapprox.C_bzip
spneumo_pangenome_k32	1.0	prophasm	11	na	runsapprox	xz	1545282	2529792	2201757	328035	170966	98451	2529792	704208	635820	166276	802096	796628	spneumo_pangenome_k32.r_1.0.S_prophasm.k_11.d_na.M_runsapprox.C_xz
spneumo_pangenome_k32	0.000000001	eulertigs	13	na	default	bzip	1	13	1	12	1	1	13	80	80	41	121	80	spneumo_pangenome_k32.r_0.000000001.S_eulertigs.k_13.d_na.M_default.C_bzip
spneumo_pangenome_k32	0.000000001	eulertigs	13	na	default	xz	1	13	1	12	1	1	13	80	80	76	156	80	spneumo_pangenome_k32.r_0.000000001.S_eulertigs.k_13.d_na.M_default.C_xz
spneumo_pangenome_k32	0.000000001	eulertigs	13	na	ones	bzip	1	13	1	12	1	1	13	80	80	41	121	80	spneumo_pangenome_k32.r_0.000000001.S_eulertigs.k_13.d_na.M_ones.C_bzip
spneumo_pangenome_k32	0.000000001	eulertigs	13	na	ones	xz	1	13	1	12	1	1	13	80	80	76	156	80	spneumo_pangenome_k32.r_0.000000001.S_eulertigs.k_13.d_na.M_ones.C_xz
spneumo_pangenome_k32	0.000000001	eulertigs	13	na	runsapprox	bzip	1	13	1	12	1	1	13	80	80	41	121	80	spneumo_pangenome_k32.r_0.000000001.S_eulertigs.k_13.d_na.M_runsapprox.C_bzip
spneumo_pangenome_k32	0.000000001	eulertigs	13	na	runsapprox	xz	1	13	1	12	1	1	13	80	80	76	156	80	spneumo_pangenome_k32.r_0.000000001.S_eulertigs.k_13.d_na.M_runsapprox.C_xz
spneumo_pangenome_k32	0.0001	eulertigs	13	na	default	bzip	503	6539	503	6036	503	503	6539	2196	2036	46	2082	2156	spneumo_pangenome_k32.r_0.0001.S_eulertigs.k_13.d_na.M_default.C_bzip
spneumo_pangenome_k32	0.0001	eulertigs	13	na	default	xz	503	6539	503	6036	503	503	6539	2196	2036	112	2148	2156	spneumo_pangenome_k32.r_0.0001.S_eulertigs.k_13.d_na.M_default.C_xz
spneumo_pangenome_k32	0.0001	eulertigs	13	na	ones	bzip	503	6539	504	6035	504	503	6539	2196	2036	49	2085	2160	spneumo_pangenome_k32.r_0.0001.S_eulertigs.k_13.d_na.M_ones.C_bzip
spneumo_pangenome_k32	0.0001	eulertigs	13	na	ones	xz	503	6539	504	6035	504	503	6539	2196	2036	116	2152	2160	spneumo_pangenome_k32.r_0.0001.S_eulertigs.k_13.d_na.M_ones.C_xz
spneumo_pangenome_k32	0.0001	eulertigs	13	na	runsapprox	bzip	503	6539	504	6035	504	503	6539	2196	2036	49	2085	2160	spneumo_pangenome_k32.r_0.0001.S_eulertigs.k_13.d_na.M_runsapprox.C_bzip
spneumo_pangenome_k32	0.0001	eulertigs	13	na	runsapprox	xz	503	6539	504	6035	504	503	6539	2196	2036	116	2152	2160	spneumo_pangenome_k32.r_0.0001.S_eulertigs.k_13.d_na.M_runsapprox.C_xz
spneumo_pangenome_k32	0.001	eulertigs	13	na	default	bzip	5038	65362	5038	60324	5027	5027	65362	17924	16768	69	16837	17852	spneumo_pangenome_k32.r_0.001.S_eulertigs.k_13.d_na.M_default.C_bzip
spneumo_pangenome_k32	0.001	eulertigs	13	na	default	xz	5038	65362	5038	60324	5027	5027	65362	17924	16768	196	16964	17852	spneumo_pangenome_k32.r_0.001.S_eulertigs.k_13.d_na.M_default.C_xz
spneumo_pangenome_k32	0.001	eulertigs	13	na	ones	bzip	5038	65362	5058	60304	5046	5027	65362	17924	16768	144	16912	17908	spneumo_pangenome_k32.r_0.001.S_eulertigs.k_13.d_na.M_ones.C_bzip
spneumo_pangenome_k32	0.001	eulertigs	13	na	ones	xz	5038	65362	5058	60304	5046	5027	65362	17924	16768	292	17060	17908	spneumo_pangenome_k32.r_0.001.S_eulertigs.k_13.d_na.M_ones.C_xz
spneumo_pangenome_k32	0.001	eulertigs	13	na	runsapprox	bzip	5038	65362	5058	60304	5046	5027	65362	17924	16768	144	16912	17908	spneumo_pangenome_k32.r_0.001.S_eulertigs.k_13.d_na.M_runsapprox.C_bzip
spneumo_pangenome_k32	0.001	eulertigs	13	na	runsapprox	xz	5038	65362	5058	60304	5046	5027	65362	17924	16768	292	17060	17908	spneumo_pangenome_k32.r_0.001.S_eulertigs.k_13.d_na.M_runsapprox.C_xz
spneumo_pangenome_k32	0.01	eulertigs	13	na	default	bzip	50385	644565	50385	594180	49515	49515	644565	180816	164280	1425	165705	181736	spneumo_pangenome_k32.r_0.01.S_eulertigs.k_13.d_na.M_default.C_bzip
spneumo_pangenome_k32	0.01	eulertigs	13	na	default	xz	50385	644565	50385	594180	49515	49515	644565	180816	164280	2316	166596	181736	spneumo_pangenome_k32.r_0.01.S_eulertigs.k_13.d_na.M_default.C_xz
spneumo_pangenome_k32	0.01	eulertigs	13	na	ones	bzip	50385	644565	51965	592600	51080	49515	644565	180816	164280	4180	168460	183856	spneumo_pangenome_k32.r_0.01.S_eulertigs.k_13.d_na.M_ones.C_bzip
spneumo_pangenome_k32	0.01	eulertigs	13	na	ones	xz	50385	644565	51965	592600	51080	49515	644565	180816	164280	7100	171380	183856	spneumo_pangenome_k32.r_0.01.S_eulertigs.k_13.d_na.M_ones.C_xz
spneumo_pangenome_k32	0.01	eulertigs	13	na	runsapprox	bzip	50385	644565	51965	592600	51080	49515	644565	180816	164280	4180	168460	183856	spneumo_pangenome_k32.r_0.01.S_eulertigs.k_13.d_na.M_runsapprox.C_bzip
spneumo_pangenome_k32	0.01	eulertigs	13	na	runsapprox	xz	50385	644565	51965	592600	51080	49515	644565	180816	164280	7100	171380	183856	spneumo_pangenome_k32.r_0.01.S_eulertigs.k_13.d_na.M_runsapprox.C_xz
spneumo_pangenome_k32	0.05	eulertigs	13	na	default	bzip	251927	3017915	251927	2765988	230499	230499	3017915	843692	769116	20824	789940	865612	spneumo_pangenome_k32.r_0.05.S_eulertigs.k_13.d_na.M_default.C_bzip
spneumo_pangenome_k32	0.05	eulertigs	13	na	default	xz	251927	3017915	251927	2765988	230499	230499	3017915	843692	769116	30896	800012	865612	spneumo_pangenome_k32.r_0.05.S_eulertigs.k_13.d_na.M_default.C_xz
spneumo_pangenome_k32	0.05	eulertigs	13	na	ones	bzip	251927	3017915	286975	2730940	264282	230499	3017915	843692	769116	65059	834175	909996	spneumo_pangenome_k32.r_0.05.S_eulertigs.k_13.d_na.M_ones.C_bzip
spneumo_pangenome_k32	0.05	eulertigs	13	na	ones	xz	251927	3017915	286975	2730940	264282	230499	3017915	843692	769116	91288	860404	909996	spneumo_pangenome_k32.r_0.05.S_eulertigs.k_13.d_na.M_ones.C_xz
spneumo_pangenome_k32	0.05	eulertigs	13	na	runsapprox	bzip	251927	3017915	286975	2730940	264282	230499	3017915	843692	769116	65059	834175	909996	spneumo_pangenome_k32.r_0.05.S_eulertigs.k_13.d_na.M_runsapprox.C_bzip
spneumo_pangenome_k32	0.05	eulertigs	13	na	runsapprox	xz	251927	3017915	286975	2730940	264282	230499	3017915	843692	769116	91288	860404	909996	spneumo_pangenome_k32.r_0.05.S_eulertigs.k_13.d_na.M_runsapprox.C_xz
spneumo_pangenome_k32	0.1	eulertigs	13	na	default	bzip	503855	5584883	503855	5081028	423419	423419	5584883	1563776	1412536	57651	1470187	1621512	spneumo_pangenome_k32.r_0.1.S_eulertigs.k_13.d_na.M_default.C_bzip
spneumo_pangenome_k32	0.1	eulertigs	13	na	default	xz	503855	5584883	503855	5081028	423419	423419	5584883	1563776	1412536	87780	1500316	1621512	spneumo_pangenome_k32.r_0.1.S_eulertigs.k_13.d_na.M_default.C_xz
spneumo_pangenome_k32	0.1	eulertigs	13	na	ones	bzip	503855	5584883	630410	4954473	541349	423419	5584883	1563776	1412536	195428	1607964	1740316	spneumo_pangenome_k32.r_0.1.S_eulertigs.k_13.d_na.M_ones.C_bzip
spneumo_pangenome_k32	0.1	eulertigs	13	na	ones	xz	503855	5584883	630410	4954473	541349	423419	5584883	1563776	1412536	242468	1655004	1740316	spneumo_pangenome_k32.r_0.1.S_eulertigs.k_13.d_na.M_ones.C_xz
spneumo_pangenome_k32	0.1	eulertigs	13	na	runsapprox	bzip	503855	5584883	630410	4954473	541349	423419	5584883	1563776	1412536	195428	1607964	1740316	spneumo_pangenome_k32.r_0.1.S_eulertigs.k_13.d_na.M_runsapprox.C_bzip
spneumo_pangenome_k32	0.1	eulertigs	13	na	runsapprox	xz	503855	5584883	630410	4954473	541349	423419	5584883	1563776	1412536	242468	1655004	1740316	spneumo_pangenome_k32.r_0.1.S_eulertigs.k_13.d_na.M_runsapprox.C_xz
spneumo_pangenome_k32	0.2	eulertigs	13	na	default	bzip	1007711	9612659	1007711	8604948	717079	717079	9612659	2853012	2493168	147660	2640828	2982428	spneumo_pangenome_k32.r_0.2.S_eulertigs.k_13.d_na.M_default.C_bzip
spneumo_pangenome_k32	0.2	eulertigs	13	na	default	xz	1007711	9612659	1007711	8604948	717079	717079	9612659	2853012	2493168	220776	2713944	2982428	spneumo_pangenome_k32.r_0.2.S_eulertigs.k_13.d_na.M_default.C_xz
spneumo_pangenome_k32	0.2	eulertigs	13	na	ones	bzip	1007711	9612659	1433412	8179247	1085032	717079	9612659	2853012	2493168	526207	3019375	3290996	spneumo_pangenome_k32.r_0.2.S_eulertigs.k_13.d_na.M_ones.C_bzip
spneumo_pangenome_k32	0.2	eulertigs	13	na	ones	xz	1007711	9612659	1433412	8179247	1085032	717079	9612659	2853012	2493168	596412	3089580	3290996	spneumo_pangenome_k32.r_0.2.S_eulertigs.k_13.d_na.M_ones.C_xz
spneumo_pangenome_k32	0.2	eulertigs	13	na	runsapprox	bzip	1007711	9612659	1433412	8179247	1085032	717079	9612659	2853012	2493168	526207	3019375	3290996	spneumo_pangenome_k32.r_0.2.S_eulertigs.k_13.d_na.M_runsapprox.C_bzip
spneumo_pangenome_k32	0.2	eulertigs	13	na	runsapprox	xz	1007711	9612659	1433412	8179247	1085032	717079	9612659	2853012	2493168	596412	3089580	3290996	spneumo_pangenome_k32.r_0.2.S_eulertigs.k_13.d_na.M_runsapprox.C_xz
spneumo_pangenome_k32	0.3	eulertigs	13	na	default	bzip	1511566	12472282	1511566	10960716	913393	913393	12472282	3767416	3242632	241650	3484282	3945604	spneumo_pangenome_k32.r_0.3.S_eulertigs.k_13.d_na.M_default.C_bzip
spneumo_pangenome_k32	0.3	eulertigs	13	na	default	xz	1511566	12472282	1511566	10960716	913393	913393	12472282	3767416	3242632	344336	3586968	3945604	spneumo_pangenome_k32.r_0.3.S_eulertigs.k_13.d_na.M_default.C_xz
spneumo_pangenome_k32	0.3	eulertigs	13	na	ones	bzip	1511566	12472282	2325035	10147247	1564929	913393	12472282	3767416	3242632	889636	4132268	4421044	spneumo_pangenome_k32.r_0.3.S_eulertigs.k_13.d_na.M_ones.C_bzip
spneumo_pangenome_k32	0.3	eulertigs	13	na	ones	xz	1511566	12472282	2325035	10147247	1564929	913393	12472282	3767416	3242632	947672	4190304	4421044	spneumo_pangenome_k32.r_0.3.S_eulertigs.k_13.d_na.M_ones.C_xz
spneumo_pangenome_k32	0.3	eulertigs	13	na	runsapprox	bzip	1511566	12472282	2325035	10147247	1564929	913393	12472282	3767416	3242632	889636	4132268	4421044	spneumo_pangenome_k32.r_0.3.S_eulertigs.k_13.d_na.M_runsapprox.C_bzip
spneumo_pangenome_k32	0.3	eulertigs	13	na	runsapprox	xz	1511566	12472282	2325035	10147247	1564929	913393	12472282	3767416	3242632	947672	4190304	4421044	spneumo_pangenome_k32.r_0.3.S_eulertigs.k_13.d_na.M_runsapprox.C_xz
spneumo_pangenome_k32	0.4	eulertigs	13	na	default	bzip	2015422	14401498	2015422	12386076	1032173	1032173	14401498	4335216	3734144	329691	4063835	4593752	spneumo_pangenome_k32.r_0.4.S_eulertigs.k_13.d_na.M_default.C_bzip
spneumo_pangenome_k32	0.4	eulertigs	13	na	default	xz	2015422	14401498	2015422	12386076	1032173	1032173	14401498	4335216	3734144	447440	4181584	4593752	spneumo_pangenome_k32.r_0.4.S_eulertigs.k_13.d_na.M_default.C_xz
spneumo_pangenome_k32	0.4	eulertigs	13	na	ones	bzip	2015422	14401498	3258709	11142789	1945852	1032173	14401498	4335216	3734144	1237500	4971644	5226940	spneumo_pangenome_k32.r_0.4.S_eulertigs.k_13.d_na.M_ones.C_bzip
spneumo_pangenome_k32	0.4	eulertigs	13	na	ones	xz	2015422	14401498	3258709	11142789	1945852	1032173	14401498	4335216	3734144	1257388	4991532	5226940	spneumo_pangenome_k32.r_0.4.S_eulertigs.k_13.d_na.M_ones.C_xz
spneumo_pangenome_k32	0.4	eulertigs	13	na	runsapprox	bzip	2015422	14401498	3258709	11142789	1945852	1032173	14401498	4335216	3734144	1237500	4971644	5226940	spneumo_pangenome_k32.r_0.4.S_eulertigs.k_13.d_na.M_runsapprox.C_bzip
spneumo_pangenome_k32	0.4	eulertigs	13	na	runsapprox	xz	2015422	14401498	3258709	11142789	1945852	1032173	14401498	4335216	3734144	1257388	4991532	5226940	spneumo_pangenome_k32.r_0.4.S_eulertigs.k_13.d_na.M_runsapprox.C_xz
spneumo_pangenome_k32	0.5	eulertigs	13	na	default	bzip	2519277	15537009	2519277	13017732	1084811	1084811	15537009	4686908	4033592	403414	4437006	5006124	spneumo_pangenome_k32.r_0.5.S_eulertigs.k_13.d_na.M_default.C_bzip
spneumo_pangenome_k32	0.5	eulertigs	13	na	default	xz	2519277	15537009	2519277	13017732	1084811	1084811	15537009	4686908	4033592	524072	4557664	5006124	spneumo_pangenome_k32.r_0.5.S_eulertigs.k_13.d_na.M_default.C_xz
spneumo_pangenome_k32	0.5	eulertigs	13	na	ones	bzip	2519277	15537009	4177050	11359959	2198264	1084811	15537009	4686908	4033592	1524297	5557889	5746944	spneumo_pangenome_k32.r_0.5.S_eulertigs.k_13.d_na.M_ones.C_bzip
spneumo_pangenome_k32	0.5	eulertigs	13	na	ones	xz	2519277	15537009	4177050	11359959	2198264	1084811	15537009	4686908	4033592	1494196	5527788	5746944	spneumo_pangenome_k32.r_0.5.S_eulertigs.k_13.d_na.M_ones.C_xz
spneumo_pangenome_k32	0.5	eulertigs	13	na	runsapprox	bzip	2519277	15537009	4177050	11359959	2198264	1084811	15537009	4686908	4033592	1524297	5557889	5746944	spneumo_pangenome_k32.r_0.5.S_eulertigs.k_13.d_na.M_runsapprox.C_bzip
spneumo_pangenome_k32	0.5	eulertigs	13	na	runsapprox	xz	2519277	15537009	4177050	11359959	2198264	1084811	15537009	4686908	4033592	1494196	5527788	5746944	spneumo_pangenome_k32.r_0.5.S_eulertigs.k_13.d_na.M_runsapprox.C_xz
spneumo_pangenome_k32	0.6	eulertigs	13	na	default	bzip	3023133	15928017	3023133	12904884	1075407	1075407	15928017	4802520	4140804	457819	4598623	5173300	spneumo_pangenome_k32.r_0.6.S_eulertigs.k_13.d_na.M_default.C_bzip
spneumo_pangenome_k32	0.6	eulertigs	13	na	default	xz	3023133	15928017	3023133	12904884	1075407	1075407	15928017	4802520	4140804	570736	4711540	5173300	spneumo_pangenome_k32.r_0.6.S_eulertigs.k_13.d_na.M_default.C_xz
spneumo_pangenome_k32	0.6	eulertigs	13	na	ones	bzip	3023133	15928017	5036845	10891172	2300138	1075407	15928017	4802520	4140804	1719910	5860714	5963504	spneumo_pangenome_k32.r_0.6.S_eulertigs.k_13.d_na.M_ones.C_bzip
spneumo_pangenome_k32	0.6	eulertigs	13	na	ones	xz	3023133	15928017	5036845	10891172	2300138	1075407	15928017	4802520	4140804	1635032	5775836	5963504	spneumo_pangenome_k32.r_0.6.S_eulertigs.k_13.d_na.M_ones.C_xz
spneumo_pangenome_k32	0.6	eulertigs	13	na	runsapprox	bzip	3023133	15928017	5036845	10891172	2300138	1075407	15928017	4802520	4140804	1719910	5860714	5963504	spneumo_pangenome_k32.r_0.6.S_eulertigs.k_13.d_na.M_runsapprox.C_bzip
spneumo_pangenome_k32	0.6	eulertigs	13	na	runsapprox	xz	3023133	15928017	5036845	10891172	2300138	1075407	15928017	4802520	4140804	1635032	5775836	5963504	spneumo_pangenome_k32.r_0.6.S_eulertigs.k_13.d_na.M_runsapprox.C_xz
spneumo_pangenome_k32	0.7	eulertigs	13	na	default	bzip	3526988	15625532	3526988	12098544	1008212	1008212	15625532	4704404	4084016	482395	4566411	5128516	spneumo_pangenome_k32.r_0.7.S_eulertigs.k_13.d_na.M_default.C_bzip
spneumo_pangenome_k32	0.7	eulertigs	13	na	default	xz	3526988	15625532	3526988	12098544	1008212	1008212	15625532	4704404	4084016	585420	4669436	5128516	spneumo_pangenome_k32.r_0.7.S_eulertigs.k_13.d_na.M_default.C_xz
spneumo_pangenome_k32	0.7	eulertigs	13	na	ones	bzip	3526988	15625532	5786196	9839336	2235535	1008212	15625532	4704404	4084016	1790867	5874883	5882708	spneumo_pangenome_k32.r_0.7.S_eulertigs.k_13.d_na.M_ones.C_bzip
spneumo_pangenome_k32	0.7	eulertigs	13	na	ones	xz	3526988	15625532	5786196	9839336	2235535	1008212	15625532	4704404	4084016	1663756	5747772	5882708	spneumo_pangenome_k32.r_0.7.S_eulertigs.k_13.d_na.M_ones.C_xz
spneumo_pangenome_k32	0.7	eulertigs	13	na	runsapprox	bzip	3526988	15625532	5786196	9839336	2235535	1008212	15625532	4704404	4084016	1790867	5874883	5882708	spneumo_pangenome_k32.r_0.7.S_eulertigs.k_13.d_na.M_runsapprox.C_bzip
spneumo_pangenome_k32	0.7	eulertigs	13	na	runsapprox	xz	3526988	15625532	5786196	9839336	2235535	1008212	15625532	4704404	4084016	1663756	5747772	5882708	spneumo_pangenome_k32.r_0.7.S_eulertigs.k_13.d_na.M_runsapprox.C_xz
spneumo_pangenome_k32	0.8	eulertigs	13	na	default	bzip	4030844	14600768	4030844	10569924	880827	880827	14600768	4386788	3823216	470658	4293874	4836436	spneumo_pangenome_k32.r_0.8.S_eulertigs.k_13.d_na.M_default.C_bzip
spneumo_pangenome_k32	0.8	eulertigs	13	na	default	xz	4030844	14600768	4030844	10569924	880827	880827	14600768	4386788	3823216	563560	4386776	4836436	spneumo_pangenome_k32.r_0.8.S_eulertigs.k_13.d_na.M_default.C_xz
spneumo_pangenome_k32	0.8	eulertigs	13	na	ones	bzip	4030844	14600768	6403866	8196902	1991487	880827	14600768	4386788	3823216	1707772	5530988	5487160	spneumo_pangenome_k32.r_0.8.S_eulertigs.k_13.d_na.M_ones.C_bzip
spneumo_pangenome_k32	0.8	eulertigs	13	na	ones	xz	4030844	14600768	6403866	8196902	1991487	880827	14600768	4386788	3823216	1565908	5389124	5487160	spneumo_pangenome_k32.r_0.8.S_eulertigs.k_13.d_na.M_ones.C_xz
spneumo_pangenome_k32	0.8	eulertigs	13	na	runsapprox	bzip	4030844	14600768	6403866	8196902	1991487	880827	14600768	4386788	3823216	1707772	5530988	5487160	spneumo_pangenome_k32.r_0.8.S_eulertigs.k_13.d_na.M_runsapprox.C_bzip
spneumo_pangenome_k32	0.8	eulertigs	13	na	runsapprox	xz	4030844	14600768	6403866	8196902	1991487	880827	14600768	4386788	3823216	1565908	5389124	5487160	spneumo_pangenome_k32.r_0.8.S_eulertigs.k_13.d_na.M_runsapprox.C_xz
spneumo_pangenome_k32	0.9	eulertigs	13	na	default	bzip	4534699	12833191	4534699	8298492	691541	691541	12833191	3822544	3343208	413913	3757121	4219944	spneumo_pangenome_k32.r_0.9.S_eulertigs.k_13.d_na.M_default.C_bzip
spneumo_pangenome_k32	0.9	eulertigs	13	na	default	xz	4534699	12833191	4534699	8298492	691541	691541	12833191	3822544	3343208	499812	3843020	4219944	spneumo_pangenome_k32.r_0.9.S_eulertigs.k_13.d_na.M_default.C_xz
spneumo_pangenome_k32	0.9	eulertigs	13	na	ones	bzip	4534699	12833191	6775305	6057886	1559693	691541	12833191	3822544	3343208	1443774	4786982	4757972	spneumo_pangenome_k32.r_0.9.S_eulertigs.k_13.d_na.M_ones.C_bzip
spneumo_pangenome_k32	0.9	eulertigs	13	na	ones	xz	4534699	12833191	6775305	6057886	1559693	691541	12833191	3822544	3343208	1327388	4670596	4757972	spneumo_pangenome_k32.r_0.9.S_eulertigs.k_13.d_na.M_ones.C_xz
spneumo_pangenome_k32	0.9	eulertigs	13	na	runsapprox	bzip	4534699	12833191	6775305	6057886	1559693	691541	12833191	3822544	3343208	1443774	4786982	4757972	spneumo_pangenome_k32.r_0.9.S_eulertigs.k_13.d_na.M_runsapprox.C_bzip
spneumo_pangenome_k32	0.9	eulertigs	13	na	runsapprox	xz	4534699	12833191	6775305	6057886	1559693	691541	12833191	3822544	3343208	1327388	4670596	4757972	spneumo_pangenome_k32.r_0.9.S_eulertigs.k_13.d_na.M_runsapprox.C_xz
spneumo_pangenome_k32	1.0	eulertigs	13	na	default	bzip	5038555	10244419	5038555	5205864	433822	433822	10244419	2993112	2660780	300811	2961591	3284488	spneumo_pangenome_k32.r_1.0.S_eulertigs.k_13.d_na.M_default.C_bzip
spneumo_pangenome_k32	1.0	eulertigs	13	na	default	xz	5038555	10244419	5038555	5205864	433822	433822	10244419	2993112	2660780	379064	3039844	3284488	spneumo_pangenome_k32.r_1.0.S_eulertigs.k_13.d_na.M_default.C_xz
spneumo_pangenome_k32	1.0	eulertigs	13	na	ones	bzip	5038555	10244419	6876413	3368006	930615	433822	10244419	2993112	2660780	963313	3624093	3627140	spneumo_pangenome_k32.r_1.0.S_eulertigs.k_13.d_na.M_ones.C_bzip
spneumo_pangenome_k32	1.0	eulertigs	13	na	ones	xz	5038555	10244419	6876413	3368006	930615	433822	10244419	2993112	2660780	913992	3574772	3627140	spneumo_pangenome_k32.r_1.0.S_eulertigs.k_13.d_na.M_ones.C_xz
spneumo_pangenome_k32	1.0	eulertigs	13	na	runsapprox	bzip	5038555	10244419	6876413	3368006	930615	433822	10244419	2993112	2660780	963313	3624093	3627140	spneumo_pangenome_k32.r_1.0.S_eulertigs.k_13.d_na.M_runsapprox.C_bzip
spneumo_pangenome_k32	1.0	eulertigs	13	na	runsapprox	xz	5038555	10244419	6876413	3368006	930615	433822	10244419	2993112	2660780	913992	3574772	3627140	spneumo_pangenome_k32.r_1.0.S_eulertigs.k_13.d_na.M_runsapprox.C_xz
spneumo_pangenome_k32	0.000000001	greedytigs	13	na	default	bzip	1	13	1	12	1	1	13	80	80	41	121	80	spneumo_pangenome_k32.r_0.000000001.S_greedytigs.k_13.d_na.M_default.C_bzip
spneumo_pangenome_k32	0.000000001	greedytigs	13	na	default	xz	1	13	1	12	1	1	13	80	80	76	156	80	spneumo_pangenome_k32.r_0.000000001.S_greedytigs.k_13.d_na.M_default.C_xz
spneumo_pangenome_k32	0.000000001	greedytigs	13	na	ones	bzip	1	13	1	12	1	1	13	80	80	41	121	80	spneumo_pangenome_k32.r_0.000000001.S_greedytigs.k_13.d_na.M_ones.C_bzip
spneumo_pangenome_k32	0.000000001	greedytigs	13	na	ones	xz	1	13	1	12	1	1	13	80	80	76	156	80	spneumo_pangenome_k32.r_0.000000001.S_greedytigs.k_13.d_na.M_ones.C_xz
spneumo_pangenome_k32	0.000000001	greedytigs	13	na	runsapprox	bzip	1	13	1	12	1	1	13	80	80	41	121	80	spneumo_pangenome_k32.r_0.000000001.S_greedytigs.k_13.d_na.M_runsapprox.C_bzip
spneumo_pangenome_k32	0.000000001	greedytigs	13	na	runsapprox	xz	1	13	1	12	1	1	13	80	80	76	156	80	spneumo_pangenome_k32.r_0.000000001.S_greedytigs.k_13.d_na.M_runsapprox.C_xz
spneumo_pangenome_k32	0.0001	greedytigs	13	na	default	bzip	503	6539	503	6036	503	503	6539	2196	2036	46	2082	2156	spneumo_pangenome_k32.r_0.0001.S_greedytigs.k_13.d_na.M_default.C_bzip
spneumo_pangenome_k32	0.0001	greedytigs	13	na	default	xz	503	6539	503	6036	503	503	6539	2196	2036	112	2148	2156	spneumo_pangenome_k32.r_0.0001.S_greedytigs.k_13.d_na.M_default.C_xz
spneumo_pangenome_k32	0.0001	greedytigs	13	na	ones	bzip	503	6539	504	6035	504	503	6539	2196	2036	49	2085	2160	spneumo_pangenome_k32.r_0.0001.S_greedytigs.k_13.d_na.M_ones.C_bzip
spneumo_pangenome_k32	0.0001	greedytigs	13	na	ones	xz	503	6539	504	6035	504	503	6539	2196	2036	116	2152	2160	spneumo_pangenome_k32.r_0.0001.S_greedytigs.k_13.d_na.M_ones.C_xz
spneumo_pangenome_k32	0.0001	greedytigs	13	na	runsapprox	bzip	503	6539	504	6035	504	503	6539	2196	2036	49	2085	2160	spneumo_pangenome_k32.r_0.0001.S_greedytigs.k_13.d_na.M_runsapprox.C_bzip
spneumo_pangenome_k32	0.0001	greedytigs	13	na	runsapprox	xz	503	6539	504	6035	504	503	6539	2196	2036	116	2152	2160	spneumo_pangenome_k32.r_0.0001.S_greedytigs.k_13.d_na.M_runsapprox.C_xz
spneumo_pangenome_k32	0.001	greedytigs	13	na	default	bzip	5038	65362	5038	60324	5027	5027	65362	17924	16768	69	16837	17852	spneumo_pangenome_k32.r_0.001.S_greedytigs.k_13.d_na.M_default.C_bzip
spneumo_pangenome_k32	0.001	greedytigs	13	na	default	xz	5038	65362	5038	60324	5027	5027	65362	17924	16768	196	16964	17852	spneumo_pangenome_k32.r_0.001.S_greedytigs.k_13.d_na.M_default.C_xz
spneumo_pangenome_k32	0.001	greedytigs	13	na	ones	bzip	5038	65362	5058	60304	5046	5027	65362	17924	16768	144	16912	17908	spneumo_pangenome_k32.r_0.001.S_greedytigs.k_13.d_na.M_ones.C_bzip
spneumo_pangenome_k32	0.001	greedytigs	13	na	ones	xz	5038	65362	5058	60304	5046	5027	65362	17924	16768	292	17060	17908	spneumo_pangenome_k32.r_0.001.S_greedytigs.k_13.d_na.M_ones.C_xz
spneumo_pangenome_k32	0.001	greedytigs	13	na	runsapprox	bzip	5038	65362	5058	60304	5046	5027	65362	17924	16768	144	16912	17908	spneumo_pangenome_k32.r_0.001.S_greedytigs.k_13.d_na.M_runsapprox.C_bzip
spneumo_pangenome_k32	0.001	greedytigs	13	na	runsapprox	xz	5038	65362	5058	60304	5046	5027	65362	17924	16768	292	17060	17908	spneumo_pangenome_k32.r_0.001.S_greedytigs.k_13.d_na.M_runsapprox.C_xz
spneumo_pangenome_k32	0.01	greedytigs	13	na	default	bzip	50385	644565	50385	594180	49515	49515	644565	180808	164308	1423	165731	181852	spneumo_pangenome_k32.r_0.01.S_greedytigs.k_13.d_na.M_default.C_bzip
spneumo_pangenome_k32	0.01	greedytigs	13	na	default	xz	50385	644565	50385	594180	49515	49515	644565	180808	164308	2316	166624	181852	spneumo_pangenome_k32.r_0.01.S_greedytigs.k_13.d_na.M_default.C_xz
spneumo_pangenome_k32	0.01	greedytigs	13	na	ones	bzip	50385	644565	51964	592601	51079	49515	644565	180808	164308	4182	168490	183796	spneumo_pangenome_k32.r_0.01.S_greedytigs.k_13.d_na.M_ones.C_bzip
spneumo_pangenome_k32	0.01	greedytigs	13	na	ones	xz	50385	644565	51964	592601	51079	49515	644565	180808	164308	7096	171404	183796	spneumo_pangenome_k32.r_0.01.S_greedytigs.k_13.d_na.M_ones.C_xz
spneumo_pangenome_k32	0.01	greedytigs	13	na	runsapprox	bzip	50385	644565	51964	592601	51079	49515	644565	180808	164308	4182	168490	183796	spneumo_pangenome_k32.r_0.01.S_greedytigs.k_13.d_na.M_runsapprox.C_bzip
spneumo_pangenome_k32	0.01	greedytigs	13	na	runsapprox	xz	50385	644565	51964	592601	51079	49515	644565	180808	164308	7096	171404	183796	spneumo_pangenome_k32.r_0.01.S_greedytigs.k_13.d_na.M_runsapprox.C_xz
spneumo_pangenome_k32	0.05	greedytigs	13	na	default	bzip	251927	3017882	251930	2765952	230496	230496	3017882	845840	768464	20822	789286	866164	spneumo_pangenome_k32.r_0.05.S_greedytigs.k_13.d_na.M_default.C_bzip
spneumo_pangenome_k32	0.05	greedytigs	13	na	default	xz	251927	3017882	251930	2765952	230496	230496	3017882	845840	768464	30896	799360	866164	spneumo_pangenome_k32.r_0.05.S_greedytigs.k_13.d_na.M_default.C_xz
spneumo_pangenome_k32	0.05	greedytigs	13	na	ones	bzip	251927	3017882	286732	2731150	264131	230496	3017882	845840	768464	64476	832940	913080	spneumo_pangenome_k32.r_0.05.S_greedytigs.k_13.d_na.M_ones.C_bzip
spneumo_pangenome_k32	0.05	greedytigs	13	na	ones	xz	251927	3017882	286732	2731150	264131	230496	3017882	845840	768464	90984	859448	913080	spneumo_pangenome_k32.r_0.05.S_greedytigs.k_13.d_na.M_ones.C_xz
spneumo_pangenome_k32	0.05	greedytigs	13	na	runsapprox	bzip	251927	3017882	286732	2731150	264131	230496	3017882	845840	768464	64476	832940	913080	spneumo_pangenome_k32.r_0.05.S_greedytigs.k_13.d_na.M_runsapprox.C_bzip
spneumo_pangenome_k32	0.05	greedytigs	13	na	runsapprox	xz	251927	3017882	286732	2731150	264131	230496	3017882	845840	768464	90984	859448	913080	spneumo_pangenome_k32.r_0.05.S_greedytigs.k_13.d_na.M_runsapprox.C_xz
spneumo_pangenome_k32	0.1	greedytigs	13	na	default	bzip	503855	5584135	503935	5080200	423350	423350	5584135	1565304	1411576	57787	1469363	1622132	spneumo_pangenome_k32.r_0.1.S_greedytigs.k_13.d_na.M_default.C_bzip
spneumo_pangenome_k32	0.1	greedytigs	13	na	default	xz	503855	5584135	503935	5080200	423350	423350	5584135	1565304	1411576	87760	1499336	1622132	spneumo_pangenome_k32.r_0.1.S_greedytigs.k_13.d_na.M_default.C_xz
spneumo_pangenome_k32	0.1	greedytigs	13	na	ones	bzip	503855	5584135	631402	4952733	542125	423350	5584135	1565304	1411576	198031	1609607	1743320	spneumo_pangenome_k32.r_0.1.S_greedytigs.k_13.d_na.M_ones.C_bzip
spneumo_pangenome_k32	0.1	greedytigs	13	na	ones	xz	503855	5584135	631402	4952733	542125	423350	5584135	1565304	1411576	243016	1654592	1743320	spneumo_pangenome_k32.r_0.1.S_greedytigs.k_13.d_na.M_ones.C_xz
spneumo_pangenome_k32	0.1	greedytigs	13	na	runsapprox	bzip	503855	5584135	631402	4952733	542125	423350	5584135	1565304	1411576	198031	1609607	1743320	spneumo_pangenome_k32.r_0.1.S_greedytigs.k_13.d_na.M_runsapprox.C_bzip
spneumo_pangenome_k32	0.1	greedytigs	13	na	runsapprox	xz	503855	5584135	631402	4952733	542125	423350	5584135	1565304	1411576	243016	1654592	1743320	spneumo_pangenome_k32.r_0.1.S_greedytigs.k_13.d_na.M_runsapprox.C_xz
spneumo_pangenome_k32	0.2	greedytigs	13	na	default	bzip	1007711	9594914	1010270	8584644	715387	715387	9594914	2852908	2490324	148924	2639248	2976828	spneumo_pangenome_k32.r_0.2.S_greedytigs.k_13.d_na.M_default.C_bzip
spneumo_pangenome_k32	0.2	greedytigs	13	na	default	xz	1007711	9594914	1010270	8584644	715387	715387	9594914	2852908	2490324	222236	2712560	2976828	spneumo_pangenome_k32.r_0.2.S_greedytigs.k_13.d_na.M_default.C_xz
spneumo_pangenome_k32	0.2	greedytigs	13	na	ones	bzip	1007711	9594914	1434433	8160481	1083380	715387	9594914	2852908	2490324	526443	3016767	3272944	spneumo_pangenome_k32.r_0.2.S_greedytigs.k_13.d_na.M_ones.C_bzip
spneumo_pangenome_k32	0.2	greedytigs	13	na	ones	xz	1007711	9594914	1434433	8160481	1083380	715387	9594914	2852908	2490324	596328	3086652	3272944	spneumo_pangenome_k32.r_0.2.S_greedytigs.k_13.d_na.M_ones.C_xz
spneumo_pangenome_k32	0.2	greedytigs	13	na	runsapprox	bzip	1007711	9594914	1434433	8160481	1083380	715387	9594914	2852908	2490324	526443	3016767	3272944	spneumo_pangenome_k32.r_0.2.S_greedytigs.k_13.d_na.M_runsapprox.C_bzip
spneumo_pangenome_k32	0.2	greedytigs	13	na	runsapprox	xz	1007711	9594914	1434433	8160481	1083380	715387	9594914	2852908	2490324	596328	3086652	3272944	spneumo_pangenome_k32.r_0.2.S_greedytigs.k_13.d_na.M_runsapprox.C_xz
spneumo_pangenome_k32	0.3	greedytigs	13	na	default	bzip	1511566	12382230	1530342	10851888	904324	904324	12382230	3745192	3219108	245986	3465094	3920700	spneumo_pangenome_k32.r_0.3.S_greedytigs.k_13.d_na.M_default.C_bzip
spneumo_pangenome_k32	0.3	greedytigs	13	na	default	xz	1511566	12382230	1530342	10851888	904324	904324	12382230	3745192	3219108	348472	3567580	3920700	spneumo_pangenome_k32.r_0.3.S_greedytigs.k_13.d_na.M_default.C_xz
spneumo_pangenome_k32	0.3	greedytigs	13	na	ones	bzip	1511566	12382230	2324590	10057640	1546957	904324	12382230	3745192	3219108	881432	4100540	4392124	spneumo_pangenome_k32.r_0.3.S_greedytigs.k_13.d_na.M_ones.C_bzip
spneumo_pangenome_k32	0.3	greedytigs	13	na	ones	xz	1511566	12382230	2324590	10057640	1546957	904324	12382230	3745192	3219108	939396	4158504	4392124	spneumo_pangenome_k32.r_0.3.S_greedytigs.k_13.d_na.M_ones.C_xz
spneumo_pangenome_k32	0.3	greedytigs	13	na	runsapprox	bzip	1511566	12382230	2324590	10057640	1546957	904324	12382230	3745192	3219108	881432	4100540	4392124	spneumo_pangenome_k32.r_0.3.S_greedytigs.k_13.d_na.M_runsapprox.C_bzip
spneumo_pangenome_k32	0.3	greedytigs	13	na	runsapprox	xz	1511566	12382230	2324590	10057640	1546957	904324	12382230	3745192	3219108	939396	4158504	4392124	spneumo_pangenome_k32.r_0.3.S_greedytigs.k_13.d_na.M_runsapprox.C_xz
spneumo_pangenome_k32	0.4	greedytigs	13	na	default	bzip	2015422	14137452	2101260	12036192	1003016	1003016	14137452	4266840	3674244	342643	4016887	4525704	spneumo_pangenome_k32.r_0.4.S_greedytigs.k_13.d_na.M_default.C_bzip
spneumo_pangenome_k32	0.4	greedytigs	13	na	default	xz	2015422	14137452	2101260	12036192	1003016	1003016	14137452	4266840	3674244	454720	4128964	4525704	spneumo_pangenome_k32.r_0.4.S_greedytigs.k_13.d_na.M_default.C_xz
spneumo_pangenome_k32	0.4	greedytigs	13	na	ones	bzip	2015422	14137452	3265115	10872337	1879281	1003016	14137452	4266840	3674244	1204274	4878518	5132760	spneumo_pangenome_k32.r_0.4.S_greedytigs.k_13.d_na.M_ones.C_bzip
spneumo_pangenome_k32	0.4	greedytigs	13	na	ones	xz	2015422	14137452	3265115	10872337	1879281	1003016	14137452	4266840	3674244	1222324	4896568	5132760	spneumo_pangenome_k32.r_0.4.S_greedytigs.k_13.d_na.M_ones.C_xz
spneumo_pangenome_k32	0.4	greedytigs	13	na	runsapprox	bzip	2015422	14137452	3265115	10872337	1879281	1003016	14137452	4266840	3674244	1204274	4878518	5132760	spneumo_pangenome_k32.r_0.4.S_greedytigs.k_13.d_na.M_runsapprox.C_bzip
spneumo_pangenome_k32	0.4	greedytigs	13	na	runsapprox	xz	2015422	14137452	3265115	10872337	1879281	1003016	14137452	4266840	3674244	1222324	4896568	5132760	spneumo_pangenome_k32.r_0.4.S_greedytigs.k_13.d_na.M_runsapprox.C_xz
spneumo_pangenome_k32	0.5	greedytigs	13	na	default	bzip	2519277	14965211	2814803	12150408	1012534	1012534	14965211	4517640	3908612	426408	4335020	4872652	spneumo_pangenome_k32.r_0.5.S_greedytigs.k_13.d_na.M_default.C_bzip
spneumo_pangenome_k32	0.5	greedytigs	13	na	default	xz	2519277	14965211	2814803	12150408	1012534	1012534	14965211	4517640	3908612	531340	4439952	4872652	spneumo_pangenome_k32.r_0.5.S_greedytigs.k_13.d_na.M_default.C_xz
spneumo_pangenome_k32	0.5	greedytigs	13	na	ones	bzip	2519277	14965211	4241129	10724082	2017673	1012534	14965211	4517640	3908612	1421275	5329887	5523188	spneumo_pangenome_k32.r_0.5.S_greedytigs.k_13.d_na.M_ones.C_bzip
spneumo_pangenome_k32	0.5	greedytigs	13	na	ones	xz	2519277	14965211	4241129	10724082	2017673	1012534	14965211	4517640	3908612	1398220	5306832	5523188	spneumo_pangenome_k32.r_0.5.S_greedytigs.k_13.d_na.M_ones.C_xz
spneumo_pangenome_k32	0.5	greedytigs	13	na	runsapprox	bzip	2519277	14965211	4241129	10724082	2017673	1012534	14965211	4517640	3908612	1421275	5329887	5523188	spneumo_pangenome_k32.r_0.5.S_greedytigs.k_13.d_na.M_runsapprox.C_bzip
spneumo_pangenome_k32	0.5	greedytigs	13	na	runsapprox	xz	2519277	14965211	4241129	10724082	2017673	1012534	14965211	4517640	3908612	1398220	5306832	5523188	spneumo_pangenome_k32.r_0.5.S_greedytigs.k_13.d_na.M_runsapprox.C_xz
spneumo_pangenome_k32	0.6	greedytigs	13	na	default	bzip	3023133	14889362	3749078	11140284	928357	928357	14889362	4474628	3880656	476154	4356810	4922076	spneumo_pangenome_k32.r_0.6.S_greedytigs.k_13.d_na.M_default.C_bzip
spneumo_pangenome_k32	0.6	greedytigs	13	na	default	xz	3023133	14889362	3749078	11140284	928357	928357	14889362	4474628	3880656	564080	4444736	4922076	spneumo_pangenome_k32.r_0.6.S_greedytigs.k_13.d_na.M_default.C_xz
spneumo_pangenome_k32	0.6	greedytigs	13	na	ones	bzip	3023133	14889362	5242610	9646752	1923026	928357	14889362	4474628	3880656	1476331	5356987	5527944	spneumo_pangenome_k32.r_0.6.S_greedytigs.k_13.d_na.M_ones.C_bzip
spneumo_pangenome_k32	0.6	greedytigs	13	na	ones	xz	3023133	14889362	5242610	9646752	1923026	928357	14889362	4474628	3880656	1426644	5307300	5527944	spneumo_pangenome_k32.r_0.6.S_greedytigs.k_13.d_na.M_ones.C_xz
spneumo_pangenome_k32	0.6	greedytigs	13	na	runsapprox	bzip	3023133	14889362	5242610	9646752	1923026	928357	14889362	4474628	3880656	1476331	5356987	5527944	spneumo_pangenome_k32.r_0.6.S_greedytigs.k_13.d_na.M_runsapprox.C_bzip
spneumo_pangenome_k32	0.6	greedytigs	13	na	runsapprox	xz	3023133	14889362	5242610	9646752	1923026	928357	14889362	4474628	3880656	1426644	5307300	5527944	spneumo_pangenome_k32.r_0.6.S_greedytigs.k_13.d_na.M_runsapprox.C_xz
spneumo_pangenome_k32	0.7	greedytigs	13	na	default	bzip	3526988	13961252	4831616	9129636	760803	760803	13961252	4157828	3636848	463492	4100340	4594868	spneumo_pangenome_k32.r_0.7.S_greedytigs.k_13.d_na.M_default.C_bzip
spneumo_pangenome_k32	0.7	greedytigs	13	na	default	xz	3526988	13961252	4831616	9129636	760803	760803	13961252	4157828	3636848	542456	4179304	4594868	spneumo_pangenome_k32.r_0.7.S_greedytigs.k_13.d_na.M_default.C_xz
spneumo_pangenome_k32	0.7	greedytigs	13	na	ones	bzip	3526988	13961252	6165410	7795842	1606337	760803	13961252	4157828	3636848	1328141	4964989	5147132	spneumo_pangenome_k32.r_0.7.S_greedytigs.k_13.d_na.M_ones.C_bzip
spneumo_pangenome_k32	0.7	greedytigs	13	na	ones	xz	3526988	13961252	6165410	7795842	1606337	760803	13961252	4157828	3636848	1297912	4934760	5147132	spneumo_pangenome_k32.r_0.7.S_greedytigs.k_13.d_na.M_ones.C_xz
spneumo_pangenome_k32	0.7	greedytigs	13	na	runsapprox	bzip	3526988	13961252	6165410	7795842	1606337	760803	13961252	4157828	3636848	1328141	4964989	5147132	spneumo_pangenome_k32.r_0.7.S_greedytigs.k_13.d_na.M_runsapprox.C_bzip
spneumo_pangenome_k32	0.7	greedytigs	13	na	runsapprox	xz	3526988	13961252	6165410	7795842	1606337	760803	13961252	4157828	3636848	1297912	4934760	5147132	spneumo_pangenome_k32.r_0.7.S_greedytigs.k_13.d_na.M_runsapprox.C_xz
spneumo_pangenome_k32	0.8	greedytigs	13	na	default	bzip	4030844	12244280	5844068	6400212	533351	533351	12244280	3588032	3183828	380452	3564280	3970936	spneumo_pangenome_k32.r_0.8.S_greedytigs.k_13.d_na.M_default.C_bzip
spneumo_pangenome_k32	0.8	greedytigs	13	na	default	xz	4030844	12244280	5844068	6400212	533351	533351	12244280	3588032	3183828	471116	3654944	3970936	spneumo_pangenome_k32.r_0.8.S_greedytigs.k_13.d_na.M_default.C_xz
spneumo_pangenome_k32	0.8	greedytigs	13	na	ones	bzip	4030844	12244280	6836370	5407910	1135804	533351	12244280	3588032	3183828	1005992	4189820	4399916	spneumo_pangenome_k32.r_0.8.S_greedytigs.k_13.d_na.M_ones.C_bzip
spneumo_pangenome_k32	0.8	greedytigs	13	na	ones	xz	4030844	12244280	6836370	5407910	1135804	533351	12244280	3588032	3183828	1038584	4222412	4399916	spneumo_pangenome_k32.r_0.8.S_greedytigs.k_13.d_na.M_ones.C_xz
spneumo_pangenome_k32	0.8	greedytigs	13	na	runsapprox	bzip	4030844	12244280	6836370	5407910	1135804	533351	12244280	3588032	3183828	1005992	4189820	4399916	spneumo_pangenome_k32.r_0.8.S_greedytigs.k_13.d_na.M_runsapprox.C_bzip
spneumo_pangenome_k32	0.8	greedytigs	13	na	runsapprox	xz	4030844	12244280	6836370	5407910	1135804	533351	12244280	3588032	3183828	1038584	4222412	4399916	spneumo_pangenome_k32.r_0.8.S_greedytigs.k_13.d_na.M_runsapprox.C_xz
spneumo_pangenome_k32	0.9	greedytigs	13	na	default	bzip	4534699	9847792	6549808	3297984	274832	274832	9847792	2802432	2552724	233103	2785827	3048512	spneumo_pangenome_k32.r_0.9.S_greedytigs.k_13.d_na.M_default.C_bzip
spneumo_pangenome_k32	0.9	greedytigs	13	na	default	xz	4534699	9847792	6549808	3297984	274832	274832	9847792	2802432	2552724	335820	2888544	3048512	spneumo_pangenome_k32.r_0.9.S_greedytigs.k_13.d_na.M_default.C_xz
spneumo_pangenome_k32	0.9	greedytigs	13	na	ones	bzip	4534699	9847792	7082085	2765707	584308	274832	9847792	2802432	2552724	558118	3110842	3302220	spneumo_pangenome_k32.r_0.9.S_greedytigs.k_13.d_na.M_ones.C_bzip
spneumo_pangenome_k32	0.9	greedytigs	13	na	ones	xz	4534699	9847792	7082085	2765707	584308	274832	9847792	2802432	2552724	646344	3199068	3302220	spneumo_pangenome_k32.r_0.9.S_greedytigs.k_13.d_na.M_ones.C_xz
spneumo_pangenome_k32	0.9	greedytigs	13	na	runsapprox	bzip	4534699	9847792	7082085	2765707	584308	274832	9847792	2802432	2552724	558118	3110842	3302220	spneumo_pangenome_k32.r_0.9.S_greedytigs.k_13.d_na.M_runsapprox.C_bzip
spneumo_pangenome_k32	0.9	greedytigs	13	na	runsapprox	xz	4534699	9847792	7082085	2765707	584308	274832	9847792	2802432	2552724	646344	3199068	3302220	spneumo_pangenome_k32.r_0.9.S_greedytigs.k_13.d_na.M_runsapprox.C_xz
spneumo_pangenome_k32	1.0	greedytigs	13	na	default	bzip	5038555	6797996	6639212	158784	13232	13232	6797996	1772484	1753224	18698	1771922	1787076	spneumo_pangenome_k32.r_1.0.S_greedytigs.k_13.d_na.M_default.C_bzip
spneumo_pangenome_k32	1.0	greedytigs	13	na	default	xz	5038555	6797996	6639212	158784	13232	13232	6797996	1772484	1753224	41320	1794544	1787076	spneumo_pangenome_k32.r_1.0.S_greedytigs.k_13.d_na.M_default.C_xz
spneumo_pangenome_k32	1.0	greedytigs	13	na	ones	bzip	5038555	6797996	6662154	135842	22092	13232	6797996	1772484	1753224	32673	1785897	1794040	spneumo_pangenome_k32.r_1.0.S_greedytigs.k_13.d_na.M_ones.C_bzip
spneumo_pangenome_k32	1.0	greedytigs	13	na	ones	xz	5038555	6797996	6662154	135842	22092	13232	6797996	1772484	1753224	53740	1806964	1794040	spneumo_pangenome_k32.r_1.0.S_greedytigs.k_13.d_na.M_ones.C_xz
spneumo_pangenome_k32	1.0	greedytigs	13	na	runsapprox	bzip	5038555	6797996	6649031	148965	13232	13232	6797996	1772484	1753224	22379	1775603	1787708	spneumo_pangenome_k32.r_1.0.S_greedytigs.k_13.d_na.M_runsapprox.C_bzip
spneumo_pangenome_k32	1.0	greedytigs	13	na	runsapprox	xz	5038555	6797996	6649031	148965	13232	13232	6797996	1772484	1753224	44044	1797268	1787708	spneumo_pangenome_k32.r_1.0.S_greedytigs.k_13.d_na.M_runsapprox.C_xz
spneumo_pangenome_k32	0.000000001	prophasm	13	na	default	bzip	1	13	1	12	1	1	13	80	80	41	121	80	spneumo_pangenome_k32.r_0.000000001.S_prophasm.k_13.d_na.M_default.C_bzip
spneumo_pangenome_k32	0.000000001	prophasm	13	na	default	xz	1	13	1	12	1	1	13	80	80	76	156	80	spneumo_pangenome_k32.r_0.000000001.S_prophasm.k_13.d_na.M_default.C_xz
spneumo_pangenome_k32	0.000000001	prophasm	13	na	ones	bzip	1	13	1	12	1	1	13	80	80	41	121	80	spneumo_pangenome_k32.r_0.000000001.S_prophasm.k_13.d_na.M_ones.C_bzip
spneumo_pangenome_k32	0.000000001	prophasm	13	na	ones	xz	1	13	1	12	1	1	13	80	80	76	156	80	spneumo_pangenome_k32.r_0.000000001.S_prophasm.k_13.d_na.M_ones.C_xz
spneumo_pangenome_k32	0.000000001	prophasm	13	na	runsapprox	bzip	1	13	1	12	1	1	13	80	80	41	121	80	spneumo_pangenome_k32.r_0.000000001.S_prophasm.k_13.d_na.M_runsapprox.C_bzip
spneumo_pangenome_k32	0.000000001	prophasm	13	na	runsapprox	xz	1	13	1	12	1	1	13	80	80	76	156	80	spneumo_pangenome_k32.r_0.000000001.S_prophasm.k_13.d_na.M_runsapprox.C_xz
spneumo_pangenome_k32	0.0001	prophasm	13	na	default	bzip	503	6539	503	6036	503	503	6539	2420	2104	46	2150	2444	spneumo_pangenome_k32.r_0.0001.S_prophasm.k_13.d_na.M_default.C_bzip
spneumo_pangenome_k32	0.0001	prophasm	13	na	default	xz	503	6539	503	6036	503	503	6539	2420	2104	112	2216	2444	spneumo_pangenome_k32.r_0.0001.S_prophasm.k_13.d_na.M_default.C_xz
spneumo_pangenome_k32	0.0001	prophasm	13	na	ones	bzip	503	6539	503	6036	503	503	6539	2420	2104	46	2150	2444	spneumo_pangenome_k32.r_0.0001.S_prophasm.k_13.d_na.M_ones.C_bzip
spneumo_pangenome_k32	0.0001	prophasm	13	na	ones	xz	503	6539	503	6036	503	503	6539	2420	2104	112	2216	2444	spneumo_pangenome_k32.r_0.0001.S_prophasm.k_13.d_na.M_ones.C_xz
spneumo_pangenome_k32	0.0001	prophasm	13	na	runsapprox	bzip	503	6539	503	6036	503	503	6539	2420	2104	46	2150	2444	spneumo_pangenome_k32.r_0.0001.S_prophasm.k_13.d_na.M_runsapprox.C_bzip
spneumo_pangenome_k32	0.0001	prophasm	13	na	runsapprox	xz	503	6539	503	6036	503	503	6539	2420	2104	112	2216	2444	spneumo_pangenome_k32.r_0.0001.S_prophasm.k_13.d_na.M_runsapprox.C_xz
spneumo_pangenome_k32	0.001	prophasm	13	na	default	bzip	5038	65362	5038	60324	5027	5027	65362	21064	18244	70	18314	21384	spneumo_pangenome_k32.r_0.001.S_prophasm.k_13.d_na.M_default.C_bzip
spneumo_pangenome_k32	0.001	prophasm	13	na	default	xz	5038	65362	5038	60324	5027	5027	65362	21064	18244	196	18440	21384	spneumo_pangenome_k32.r_0.001.S_prophasm.k_13.d_na.M_default.C_xz
spneumo_pangenome_k32	0.001	prophasm	13	na	ones	bzip	5038	65362	5050	60312	5039	5027	65362	21064	18244	117	18361	21420	spneumo_pangenome_k32.r_0.001.S_prophasm.k_13.d_na.M_ones.C_bzip
spneumo_pangenome_k32	0.001	prophasm	13	na	ones	xz	5038	65362	5050	60312	5039	5027	65362	21064	18244	252	18496	21420	spneumo_pangenome_k32.r_0.001.S_prophasm.k_13.d_na.M_ones.C_xz
spneumo_pangenome_k32	0.001	prophasm	13	na	runsapprox	bzip	5038	65362	5050	60312	5039	5027	65362	21064	18244	117	18361	21420	spneumo_pangenome_k32.r_0.001.S_prophasm.k_13.d_na.M_runsapprox.C_bzip
spneumo_pangenome_k32	0.001	prophasm	13	na	runsapprox	xz	5038	65362	5050	60312	5039	5027	65362	21064	18244	252	18496	21420	spneumo_pangenome_k32.r_0.001.S_prophasm.k_13.d_na.M_runsapprox.C_xz
spneumo_pangenome_k32	0.01	prophasm	13	na	default	bzip	50385	644565	50385	594180	49515	49515	644565	199064	172604	1405	174009	201180	spneumo_pangenome_k32.r_0.01.S_prophasm.k_13.d_na.M_default.C_bzip
spneumo_pangenome_k32	0.01	prophasm	13	na	default	xz	50385	644565	50385	594180	49515	49515	644565	199064	172604	2232	174836	201180	spneumo_pangenome_k32.r_0.01.S_prophasm.k_13.d_na.M_default.C_xz
spneumo_pangenome_k32	0.01	prophasm	13	na	ones	bzip	50385	644565	51900	592665	51012	49515	644565	199064	172604	4055	176659	202256	spneumo_pangenome_k32.r_0.01.S_prophasm.k_13.d_na.M_ones.C_bzip
spneumo_pangenome_k32	0.01	prophasm	13	na	ones	xz	50385	644565	51900	592665	51012	49515	644565	199064	172604	6944	179548	202256	spneumo_pangenome_k32.r_0.01.S_prophasm.k_13.d_na.M_ones.C_xz
spneumo_pangenome_k32	0.01	prophasm	13	na	runsapprox	bzip	50385	644565	51900	592665	51012	49515	644565	199064	172604	4055	176659	202256	spneumo_pangenome_k32.r_0.01.S_prophasm.k_13.d_na.M_runsapprox.C_bzip
spneumo_pangenome_k32	0.01	prophasm	13	na	runsapprox	xz	50385	644565	51900	592665	51012	49515	644565	199064	172604	6944	179548	202256	spneumo_pangenome_k32.r_0.01.S_prophasm.k_13.d_na.M_runsapprox.C_xz
spneumo_pangenome_k32	0.05	prophasm	13	na	default	bzip	251927	3017915	251927	2765988	230499	230499	3017915	919388	796896	19638	816534	936772	spneumo_pangenome_k32.r_0.05.S_prophasm.k_13.d_na.M_default.C_bzip
spneumo_pangenome_k32	0.05	prophasm	13	na	default	xz	251927	3017915	251927	2765988	230499	230499	3017915	919388	796896	29176	826072	936772	spneumo_pangenome_k32.r_0.05.S_prophasm.k_13.d_na.M_default.C_xz
spneumo_pangenome_k32	0.05	prophasm	13	na	ones	bzip	251927	3017915	287412	2730503	264759	230499	3017915	919388	796896	64940	861836	962948	spneumo_pangenome_k32.r_0.05.S_prophasm.k_13.d_na.M_ones.C_bzip
spneumo_pangenome_k32	0.05	prophasm	13	na	ones	xz	251927	3017915	287412	2730503	264759	230499	3017915	919388	796896	91252	888148	962948	spneumo_pangenome_k32.r_0.05.S_prophasm.k_13.d_na.M_ones.C_xz
spneumo_pangenome_k32	0.05	prophasm	13	na	runsapprox	bzip	251927	3017915	287412	2730503	264759	230499	3017915	919388	796896	64940	861836	962948	spneumo_pangenome_k32.r_0.05.S_prophasm.k_13.d_na.M_runsapprox.C_bzip
spneumo_pangenome_k32	0.05	prophasm	13	na	runsapprox	xz	251927	3017915	287412	2730503	264759	230499	3017915	919388	796896	91252	888148	962948	spneumo_pangenome_k32.r_0.05.S_prophasm.k_13.d_na.M_runsapprox.C_xz
spneumo_pangenome_k32	0.1	prophasm	13	na	default	bzip	503855	5584883	503855	5081028	423419	423419	5584883	1696544	1464288	54148	1518436	1742976	spneumo_pangenome_k32.r_0.1.S_prophasm.k_13.d_na.M_default.C_bzip
spneumo_pangenome_k32	0.1	prophasm	13	na	default	xz	503855	5584883	503855	5081028	423419	423419	5584883	1696544	1464288	81516	1545804	1742976	spneumo_pangenome_k32.r_0.1.S_prophasm.k_13.d_na.M_default.C_xz
spneumo_pangenome_k32	0.1	prophasm	13	na	ones	bzip	503855	5584883	633128	4951755	543737	423419	5584883	1696544	1464288	193835	1658123	1831680	spneumo_pangenome_k32.r_0.1.S_prophasm.k_13.d_na.M_ones.C_bzip
spneumo_pangenome_k32	0.1	prophasm	13	na	ones	xz	503855	5584883	633128	4951755	543737	423419	5584883	1696544	1464288	242668	1706956	1831680	spneumo_pangenome_k32.r_0.1.S_prophasm.k_13.d_na.M_ones.C_xz
spneumo_pangenome_k32	0.1	prophasm	13	na	runsapprox	bzip	503855	5584883	633128	4951755	543737	423419	5584883	1696544	1464288	193835	1658123	1831680	spneumo_pangenome_k32.r_0.1.S_prophasm.k_13.d_na.M_runsapprox.C_bzip
spneumo_pangenome_k32	0.1	prophasm	13	na	runsapprox	xz	503855	5584883	633128	4951755	543737	423419	5584883	1696544	1464288	242668	1706956	1831680	spneumo_pangenome_k32.r_0.1.S_prophasm.k_13.d_na.M_runsapprox.C_xz
spneumo_pangenome_k32	0.2	prophasm	13	na	default	bzip	1007711	9612659	1007711	8604948	717079	717079	9612659	2914048	2515164	136833	2651997	2987296	spneumo_pangenome_k32.r_0.2.S_prophasm.k_13.d_na.M_default.C_bzip
spneumo_pangenome_k32	0.2	prophasm	13	na	default	xz	1007711	9612659	1007711	8604948	717079	717079	9612659	2914048	2515164	199632	2714796	2987296	spneumo_pangenome_k32.r_0.2.S_prophasm.k_13.d_na.M_default.C_xz
spneumo_pangenome_k32	0.2	prophasm	13	na	ones	bzip	1007711	9612659	1442255	8170404	1092506	717079	9612659	2914048	2515164	524872	3040036	3291144	spneumo_pangenome_k32.r_0.2.S_prophasm.k_13.d_na.M_ones.C_bzip
spneumo_pangenome_k32	0.2	prophasm	13	na	ones	xz	1007711	9612659	1442255	8170404	1092506	717079	9612659	2914048	2515164	594980	3110144	3291144	spneumo_pangenome_k32.r_0.2.S_prophasm.k_13.d_na.M_ones.C_xz
spneumo_pangenome_k32	0.2	prophasm	13	na	runsapprox	bzip	1007711	9612659	1442255	8170404	1092506	717079	9612659	2914048	2515164	524872	3040036	3291144	spneumo_pangenome_k32.r_0.2.S_prophasm.k_13.d_na.M_runsapprox.C_bzip
spneumo_pangenome_k32	0.2	prophasm	13	na	runsapprox	xz	1007711	9612659	1442255	8170404	1092506	717079	9612659	2914048	2515164	594980	3110144	3291144	spneumo_pangenome_k32.r_0.2.S_prophasm.k_13.d_na.M_runsapprox.C_xz
spneumo_pangenome_k32	0.3	prophasm	13	na	default	bzip	1511566	12472282	1511566	10960716	913393	913393	12472282	3777944	3263416	221187	3484603	3910976	spneumo_pangenome_k32.r_0.3.S_prophasm.k_13.d_na.M_default.C_bzip
spneumo_pangenome_k32	0.3	prophasm	13	na	default	xz	1511566	12472282	1511566	10960716	913393	913393	12472282	3777944	3263416	307432	3570848	3910976	spneumo_pangenome_k32.r_0.3.S_prophasm.k_13.d_na.M_default.C_xz
spneumo_pangenome_k32	0.3	prophasm	13	na	ones	bzip	1511566	12472282	2342946	10129336	1577304	913393	12472282	3777944	3263416	883474	4146890	4404900	spneumo_pangenome_k32.r_0.3.S_prophasm.k_13.d_na.M_ones.C_bzip
spneumo_pangenome_k32	0.3	prophasm	13	na	ones	xz	1511566	12472282	2342946	10129336	1577304	913393	12472282	3777944	3263416	942988	4206404	4404900	spneumo_pangenome_k32.r_0.3.S_prophasm.k_13.d_na.M_ones.C_xz
spneumo_pangenome_k32	0.3	prophasm	13	na	runsapprox	bzip	1511566	12472282	2342946	10129336	1577304	913393	12472282	3777944	3263416	883474	4146890	4404900	spneumo_pangenome_k32.r_0.3.S_prophasm.k_13.d_na.M_runsapprox.C_bzip
spneumo_pangenome_k32	0.3	prophasm	13	na	runsapprox	xz	1511566	12472282	2342946	10129336	1577304	913393	12472282	3777944	3263416	942988	4206404	4404900	spneumo_pangenome_k32.r_0.3.S_prophasm.k_13.d_na.M_runsapprox.C_xz
spneumo_pangenome_k32	0.4	prophasm	13	na	default	bzip	2015422	14401498	2015422	12386076	1032173	1032173	14401498	4357928	3764492	294424	4058916	4620496	spneumo_pangenome_k32.r_0.4.S_prophasm.k_13.d_na.M_default.C_bzip
spneumo_pangenome_k32	0.4	prophasm	13	na	default	xz	2015422	14401498	2015422	12386076	1032173	1032173	14401498	4357928	3764492	393620	4158112	4620496	spneumo_pangenome_k32.r_0.4.S_prophasm.k_13.d_na.M_default.C_xz
spneumo_pangenome_k32	0.4	prophasm	13	na	ones	bzip	2015422	14401498	3277465	11124033	1958386	1032173	14401498	4357928	3764492	1214016	4978508	5203960	spneumo_pangenome_k32.r_0.4.S_prophasm.k_13.d_na.M_ones.C_bzip
spneumo_pangenome_k32	0.4	prophasm	13	na	ones	xz	2015422	14401498	3277465	11124033	1958386	1032173	14401498	4357928	3764492	1241236	5005728	5203960	spneumo_pangenome_k32.r_0.4.S_prophasm.k_13.d_na.M_ones.C_xz
spneumo_pangenome_k32	0.4	prophasm	13	na	runsapprox	bzip	2015422	14401498	3277465	11124033	1958386	1032173	14401498	4357928	3764492	1214016	4978508	5203960	spneumo_pangenome_k32.r_0.4.S_prophasm.k_13.d_na.M_runsapprox.C_bzip
spneumo_pangenome_k32	0.4	prophasm	13	na	runsapprox	xz	2015422	14401498	3277465	11124033	1958386	1032173	14401498	4357928	3764492	1241236	5005728	5203960	spneumo_pangenome_k32.r_0.4.S_prophasm.k_13.d_na.M_runsapprox.C_xz
spneumo_pangenome_k32	0.5	prophasm	13	na	default	bzip	2519277	15537033	2519277	13017756	1084813	1084813	15537033	4695772	4061572	351066	4412638	5011736	spneumo_pangenome_k32.r_0.5.S_prophasm.k_13.d_na.M_default.C_bzip
spneumo_pangenome_k32	0.5	prophasm	13	na	default	xz	2519277	15537033	2519277	13017756	1084813	1084813	15537033	4695772	4061572	457172	4518744	5011736	spneumo_pangenome_k32.r_0.5.S_prophasm.k_13.d_na.M_default.C_xz
spneumo_pangenome_k32	0.5	prophasm	13	na	ones	bzip	2519277	15537033	4200226	11336807	2212528	1084813	15537033	4695772	4061572	1483752	5545324	5710768	spneumo_pangenome_k32.r_0.5.S_prophasm.k_13.d_na.M_ones.C_bzip
spneumo_pangenome_k32	0.5	prophasm	13	na	ones	xz	2519277	15537033	4200226	11336807	2212528	1084813	15537033	4695772	4061572	1466956	5528528	5710768	spneumo_pangenome_k32.r_0.5.S_prophasm.k_13.d_na.M_ones.C_xz
spneumo_pangenome_k32	0.5	prophasm	13	na	runsapprox	bzip	2519277	15537033	4200226	11336807	2212528	1084813	15537033	4695772	4061572	1483752	5545324	5710768	spneumo_pangenome_k32.r_0.5.S_prophasm.k_13.d_na.M_runsapprox.C_bzip
spneumo_pangenome_k32	0.5	prophasm	13	na	runsapprox	xz	2519277	15537033	4200226	11336807	2212528	1084813	15537033	4695772	4061572	1466956	5528528	5710768	spneumo_pangenome_k32.r_0.5.S_prophasm.k_13.d_na.M_runsapprox.C_xz
spneumo_pangenome_k32	0.6	prophasm	13	na	default	bzip	3023133	15928017	3023133	12904884	1075407	1075407	15928017	4804724	4158748	386952	4545700	5157844	spneumo_pangenome_k32.r_0.6.S_prophasm.k_13.d_na.M_default.C_bzip
spneumo_pangenome_k32	0.6	prophasm	13	na	default	xz	3023133	15928017	3023133	12904884	1075407	1075407	15928017	4804724	4158748	496580	4655328	5157844	spneumo_pangenome_k32.r_0.6.S_prophasm.k_13.d_na.M_default.C_xz
spneumo_pangenome_k32	0.6	prophasm	13	na	ones	bzip	3023133	15928017	5065427	10862590	2311262	1075407	15928017	4804724	4158748	1659857	5818605	5923420	spneumo_pangenome_k32.r_0.6.S_prophasm.k_13.d_na.M_ones.C_bzip
spneumo_pangenome_k32	0.6	prophasm	13	na	ones	xz	3023133	15928017	5065427	10862590	2311262	1075407	15928017	4804724	4158748	1600684	5759432	5923420	spneumo_pangenome_k32.r_0.6.S_prophasm.k_13.d_na.M_ones.C_xz
spneumo_pangenome_k32	0.6	prophasm	13	na	runsapprox	bzip	3023133	15928017	5065427	10862590	2311262	1075407	15928017	4804724	4158748	1659857	5818605	5923420	spneumo_pangenome_k32.r_0.6.S_prophasm.k_13.d_na.M_runsapprox.C_bzip
spneumo_pangenome_k32	0.6	prophasm	13	na	runsapprox	xz	3023133	15928017	5065427	10862590	2311262	1075407	15928017	4804724	4158748	1600684	5759432	5923420	spneumo_pangenome_k32.r_0.6.S_prophasm.k_13.d_na.M_runsapprox.C_xz
spneumo_pangenome_k32	0.7	prophasm	13	na	default	bzip	3526988	15625532	3526988	12098544	1008212	1008212	15625532	4704784	4082856	399187	4482043	5070084	spneumo_pangenome_k32.r_0.7.S_prophasm.k_13.d_na.M_default.C_bzip
spneumo_pangenome_k32	0.7	prophasm	13	na	default	xz	3526988	15625532	3526988	12098544	1008212	1008212	15625532	4704784	4082856	510696	4593552	5070084	spneumo_pangenome_k32.r_0.7.S_prophasm.k_13.d_na.M_default.C_xz
spneumo_pangenome_k32	0.7	prophasm	13	na	ones	bzip	3526988	15625532	5822387	9803145	2244036	1008212	15625532	4704784	4082856	1716191	5799047	5844004	spneumo_pangenome_k32.r_0.7.S_prophasm.k_13.d_na.M_ones.C_bzip
spneumo_pangenome_k32	0.7	prophasm	13	na	ones	xz	3526988	15625532	5822387	9803145	2244036	1008212	15625532	4704784	4082856	1626880	5709736	5844004	spneumo_pangenome_k32.r_0.7.S_prophasm.k_13.d_na.M_ones.C_xz
spneumo_pangenome_k32	0.7	prophasm	13	na	runsapprox	bzip	3526988	15625532	5822387	9803145	2244036	1008212	15625532	4704784	4082856	1716191	5799047	5844004	spneumo_pangenome_k32.r_0.7.S_prophasm.k_13.d_na.M_runsapprox.C_bzip
spneumo_pangenome_k32	0.7	prophasm	13	na	runsapprox	xz	3526988	15625532	5822387	9803145	2244036	1008212	15625532	4704784	4082856	1626880	5709736	5844004	spneumo_pangenome_k32.r_0.7.S_prophasm.k_13.d_na.M_runsapprox.C_xz
spneumo_pangenome_k32	0.8	prophasm	13	na	default	bzip	4030844	14600780	4030844	10569936	880828	880828	14600780	4375232	3820040	384857	4204897	4730280	spneumo_pangenome_k32.r_0.8.S_prophasm.k_13.d_na.M_default.C_bzip
spneumo_pangenome_k32	0.8	prophasm	13	na	default	xz	4030844	14600780	4030844	10569936	880828	880828	14600780	4375232	3820040	495108	4315148	4730280	spneumo_pangenome_k32.r_0.8.S_prophasm.k_13.d_na.M_default.C_xz
spneumo_pangenome_k32	0.8	prophasm	13	na	ones	bzip	4030844	14600780	6418299	8182481	1995241	880828	14600780	4375232	3820040	1629530	5449570	5450840	spneumo_pangenome_k32.r_0.8.S_prophasm.k_13.d_na.M_ones.C_bzip
spneumo_pangenome_k32	0.8	prophasm	13	na	ones	xz	4030844	14600780	6418299	8182481	1995241	880828	14600780	4375232	3820040	1529744	5349784	5450840	spneumo_pangenome_k32.r_0.8.S_prophasm.k_13.d_na.M_ones.C_xz
spneumo_pangenome_k32	0.8	prophasm	13	na	runsapprox	bzip	4030844	14600780	6418299	8182481	1995241	880828	14600780	4375232	3820040	1629530	5449570	5450840	spneumo_pangenome_k32.r_0.8.S_prophasm.k_13.d_na.M_runsapprox.C_bzip
spneumo_pangenome_k32	0.8	prophasm	13	na	runsapprox	xz	4030844	14600780	6418299	8182481	1995241	880828	14600780	4375232	3820040	1529744	5349784	5450840	spneumo_pangenome_k32.r_0.8.S_prophasm.k_13.d_na.M_runsapprox.C_xz
spneumo_pangenome_k32	0.9	prophasm	13	na	default	bzip	4534699	12833191	4534699	8298492	691541	691541	12833191	3807732	3340252	337465	3677717	4119584	spneumo_pangenome_k32.r_0.9.S_prophasm.k_13.d_na.M_default.C_bzip
spneumo_pangenome_k32	0.9	prophasm	13	na	default	xz	4534699	12833191	4534699	8298492	691541	691541	12833191	3807732	3340252	441796	3782048	4119584	spneumo_pangenome_k32.r_0.9.S_prophasm.k_13.d_na.M_default.C_xz
spneumo_pangenome_k32	0.9	prophasm	13	na	ones	bzip	4534699	12833191	6796120	6037071	1560722	691541	12833191	3807732	3340252	1374185	4714437	4714852	spneumo_pangenome_k32.r_0.9.S_prophasm.k_13.d_na.M_ones.C_bzip
spneumo_pangenome_k32	0.9	prophasm	13	na	ones	xz	4534699	12833191	6796120	6037071	1560722	691541	12833191	3807732	3340252	1293284	4633536	4714852	spneumo_pangenome_k32.r_0.9.S_prophasm.k_13.d_na.M_ones.C_xz
spneumo_pangenome_k32	0.9	prophasm	13	na	runsapprox	bzip	4534699	12833191	6796120	6037071	1560722	691541	12833191	3807732	3340252	1374185	4714437	4714852	spneumo_pangenome_k32.r_0.9.S_prophasm.k_13.d_na.M_runsapprox.C_bzip
spneumo_pangenome_k32	0.9	prophasm	13	na	runsapprox	xz	4534699	12833191	6796120	6037071	1560722	691541	12833191	3807732	3340252	1293284	4633536	4714852	spneumo_pangenome_k32.r_0.9.S_prophasm.k_13.d_na.M_runsapprox.C_xz
spneumo_pangenome_k32	1.0	prophasm	13	na	default	bzip	5038555	10244467	5038555	5205912	433826	433826	10244467	2938040	2629240	258842	2888082	3191984	spneumo_pangenome_k32.r_1.0.S_prophasm.k_13.d_na.M_default.C_bzip
spneumo_pangenome_k32	1.0	prophasm	13	na	default	xz	5038555	10244467	5038555	5205912	433826	433826	10244467	2938040	2629240	345388	2974628	3191984	spneumo_pangenome_k32.r_1.0.S_prophasm.k_13.d_na.M_default.C_xz
spneumo_pangenome_k32	1.0	prophasm	13	na	ones	bzip	5038555	10244467	6882750	3361717	930537	433826	10244467	2938040	2629240	927746	3556986	3560476	spneumo_pangenome_k32.r_1.0.S_prophasm.k_13.d_na.M_ones.C_bzip
spneumo_pangenome_k32	1.0	prophasm	13	na	ones	xz	5038555	10244467	6882750	3361717	930537	433826	10244467	2938040	2629240	883956	3513196	3560476	spneumo_pangenome_k32.r_1.0.S_prophasm.k_13.d_na.M_ones.C_xz
spneumo_pangenome_k32	1.0	prophasm	13	na	runsapprox	bzip	5038555	10244467	6882750	3361717	930537	433826	10244467	2938040	2629240	927746	3556986	3560476	spneumo_pangenome_k32.r_1.0.S_prophasm.k_13.d_na.M_runsapprox.C_bzip
spneumo_pangenome_k32	1.0	prophasm	13	na	runsapprox	xz	5038555	10244467	6882750	3361717	930537	433826	10244467	2938040	2629240	883956	3513196	3560476	spneumo_pangenome_k32.r_1.0.S_prophasm.k_13.d_na.M_runsapprox.C_xz
spneumo_pangenome_k32	0.000000001	eulertigs	15	na	default	bzip	1	15	1	14	1	1	15	80	80	41	121	80	spneumo_pangenome_k32.r_0.000000001.S_eulertigs.k_15.d_na.M_default.C_bzip
spneumo_pangenome_k32	0.000000001	eulertigs	15	na	default	xz	1	15	1	14	1	1	15	80	80	76	156	80	spneumo_pangenome_k32.r_0.000000001.S_eulertigs.k_15.d_na.M_default.C_xz
spneumo_pangenome_k32	0.000000001	eulertigs	15	na	ones	bzip	1	15	1	14	1	1	15	80	80	41	121	80	spneumo_pangenome_k32.r_0.000000001.S_eulertigs.k_15.d_na.M_ones.C_bzip
spneumo_pangenome_k32	0.000000001	eulertigs	15	na	ones	xz	1	15	1	14	1	1	15	80	80	76	156	80	spneumo_pangenome_k32.r_0.000000001.S_eulertigs.k_15.d_na.M_ones.C_xz
spneumo_pangenome_k32	0.000000001	eulertigs	15	na	runsapprox	bzip	1	15	1	14	1	1	15	80	80	41	121	80	spneumo_pangenome_k32.r_0.000000001.S_eulertigs.k_15.d_na.M_runsapprox.C_bzip
spneumo_pangenome_k32	0.000000001	eulertigs	15	na	runsapprox	xz	1	15	1	14	1	1	15	80	80	76	156	80	spneumo_pangenome_k32.r_0.000000001.S_eulertigs.k_15.d_na.M_runsapprox.C_xz
spneumo_pangenome_k32	0.0001	eulertigs	15	na	default	bzip	663	9945	663	9282	663	663	9945	3116	2924	47	2971	3104	spneumo_pangenome_k32.r_0.0001.S_eulertigs.k_15.d_na.M_default.C_bzip
spneumo_pangenome_k32	0.0001	eulertigs	15	na	default	xz	663	9945	663	9282	663	663	9945	3116	2924	120	3044	3104	spneumo_pangenome_k32.r_0.0001.S_eulertigs.k_15.d_na.M_default.C_xz
spneumo_pangenome_k32	0.0001	eulertigs	15	na	ones	bzip	663	9945	663	9282	663	663	9945	3116	2924	47	2971	3104	spneumo_pangenome_k32.r_0.0001.S_eulertigs.k_15.d_na.M_ones.C_bzip
spneumo_pangenome_k32	0.0001	eulertigs	15	na	ones	xz	663	9945	663	9282	663	663	9945	3116	2924	120	3044	3104	spneumo_pangenome_k32.r_0.0001.S_eulertigs.k_15.d_na.M_ones.C_xz
spneumo_pangenome_k32	0.0001	eulertigs	15	na	runsapprox	bzip	663	9945	663	9282	663	663	9945	3116	2924	47	2971	3104	spneumo_pangenome_k32.r_0.0001.S_eulertigs.k_15.d_na.M_runsapprox.C_bzip
spneumo_pangenome_k32	0.0001	eulertigs	15	na	runsapprox	xz	663	9945	663	9282	663	663	9945	3116	2924	120	3044	3104	spneumo_pangenome_k32.r_0.0001.S_eulertigs.k_15.d_na.M_runsapprox.C_xz
spneumo_pangenome_k32	0.001	eulertigs	15	na	default	bzip	6634	99454	6634	92820	6630	6630	99454	26952	26000	56	26056	28624	spneumo_pangenome_k32.r_0.001.S_eulertigs.k_15.d_na.M_default.C_bzip
spneumo_pangenome_k32	0.001	eulertigs	15	na	default	xz	6634	99454	6634	92820	6630	6630	99454	26952	26000	180	26180	28624	spneumo_pangenome_k32.r_0.001.S_eulertigs.k_15.d_na.M_default.C_xz
spneumo_pangenome_k32	0.001	eulertigs	15	na	ones	bzip	6634	99454	6639	92815	6635	6630	99454	26952	26000	74	26074	28572	spneumo_pangenome_k32.r_0.001.S_eulertigs.k_15.d_na.M_ones.C_bzip
spneumo_pangenome_k32	0.001	eulertigs	15	na	ones	xz	6634	99454	6639	92815	6635	6630	99454	26952	26000	208	26208	28572	spneumo_pangenome_k32.r_0.001.S_eulertigs.k_15.d_na.M_ones.C_xz
spneumo_pangenome_k32	0.001	eulertigs	15	na	runsapprox	bzip	6634	99454	6639	92815	6635	6630	99454	26952	26000	74	26074	28572	spneumo_pangenome_k32.r_0.001.S_eulertigs.k_15.d_na.M_runsapprox.C_bzip
spneumo_pangenome_k32	0.001	eulertigs	15	na	runsapprox	xz	6634	99454	6639	92815	6635	6630	99454	26952	26000	208	26208	28572	spneumo_pangenome_k32.r_0.001.S_eulertigs.k_15.d_na.M_runsapprox.C_xz
spneumo_pangenome_k32	0.01	eulertigs	15	na	default	bzip	66346	985054	66346	918708	65622	65622	985054	273236	255056	1284	256340	281580	spneumo_pangenome_k32.r_0.01.S_eulertigs.k_15.d_na.M_default.C_bzip
spneumo_pangenome_k32	0.01	eulertigs	15	na	default	xz	66346	985054	66346	918708	65622	65622	985054	273236	255056	2276	257332	281580	spneumo_pangenome_k32.r_0.01.S_eulertigs.k_15.d_na.M_default.C_xz
spneumo_pangenome_k32	0.01	eulertigs	15	na	ones	bzip	66346	985054	66825	918229	66093	65622	985054	273236	255056	2304	257360	282100	spneumo_pangenome_k32.r_0.01.S_eulertigs.k_15.d_na.M_ones.C_bzip
spneumo_pangenome_k32	0.01	eulertigs	15	na	ones	xz	66346	985054	66825	918229	66093	65622	985054	273236	255056	4256	259312	282100	spneumo_pangenome_k32.r_0.01.S_eulertigs.k_15.d_na.M_ones.C_xz
spneumo_pangenome_k32	0.01	eulertigs	15	na	runsapprox	bzip	66346	985054	66825	918229	66093	65622	985054	273236	255056	2304	257360	282100	spneumo_pangenome_k32.r_0.01.S_eulertigs.k_15.d_na.M_runsapprox.C_bzip
spneumo_pangenome_k32	0.01	eulertigs	15	na	runsapprox	xz	66346	985054	66825	918229	66093	65622	985054	273236	255056	4256	259312	282100	spneumo_pangenome_k32.r_0.01.S_eulertigs.k_15.d_na.M_runsapprox.C_xz
spneumo_pangenome_k32	0.05	eulertigs	15	na	default	bzip	331731	4717875	331731	4386144	313296	313296	4717875	1336556	1202964	21245	1224209	1364236	spneumo_pangenome_k32.r_0.05.S_eulertigs.k_15.d_na.M_default.C_bzip
spneumo_pangenome_k32	0.05	eulertigs	15	na	default	xz	331731	4717875	331731	4386144	313296	313296	4717875	1336556	1202964	33612	1236576	1364236	spneumo_pangenome_k32.r_0.05.S_eulertigs.k_15.d_na.M_default.C_xz
spneumo_pangenome_k32	0.05	eulertigs	15	na	ones	bzip	331731	4717875	342628	4375247	323946	313296	4717875	1336556	1202964	39087	1242051	1376404	spneumo_pangenome_k32.r_0.05.S_eulertigs.k_15.d_na.M_ones.C_bzip
spneumo_pangenome_k32	0.05	eulertigs	15	na	ones	xz	331731	4717875	342628	4375247	323946	313296	4717875	1336556	1202964	63964	1266928	1376404	spneumo_pangenome_k32.r_0.05.S_eulertigs.k_15.d_na.M_ones.C_xz
spneumo_pangenome_k32	0.05	eulertigs	15	na	runsapprox	bzip	331731	4717875	342628	4375247	323946	313296	4717875	1336556	1202964	39087	1242051	1376404	spneumo_pangenome_k32.r_0.05.S_eulertigs.k_15.d_na.M_runsapprox.C_bzip
spneumo_pangenome_k32	0.05	eulertigs	15	na	runsapprox	xz	331731	4717875	342628	4375247	323946	313296	4717875	1336556	1202964	63964	1266928	1376404	spneumo_pangenome_k32.r_0.05.S_eulertigs.k_15.d_na.M_runsapprox.C_xz
spneumo_pangenome_k32	0.1	eulertigs	15	na	default	bzip	663462	8925758	663462	8262296	590164	590164	8925758	2563380	2276568	63006	2339574	2637160	spneumo_pangenome_k32.r_0.1.S_eulertigs.k_15.d_na.M_default.C_bzip
spneumo_pangenome_k32	0.1	eulertigs	15	na	default	xz	663462	8925758	663462	8262296	590164	590164	8925758	2563380	2276568	98176	2374744	2637160	spneumo_pangenome_k32.r_0.1.S_eulertigs.k_15.d_na.M_default.C_xz
spneumo_pangenome_k32	0.1	eulertigs	15	na	ones	bzip	663462	8925758	704049	8221709	628985	590164	8925758	2563380	2276568	123458	2400026	2675228	spneumo_pangenome_k32.r_0.1.S_eulertigs.k_15.d_na.M_ones.C_bzip
spneumo_pangenome_k32	0.1	eulertigs	15	na	ones	xz	663462	8925758	704049	8221709	628985	590164	8925758	2563380	2276568	189932	2466500	2675228	spneumo_pangenome_k32.r_0.1.S_eulertigs.k_15.d_na.M_ones.C_xz
spneumo_pangenome_k32	0.1	eulertigs	15	na	runsapprox	bzip	663462	8925758	704049	8221709	628985	590164	8925758	2563380	2276568	123458	2400026	2675228	spneumo_pangenome_k32.r_0.1.S_eulertigs.k_15.d_na.M_runsapprox.C_bzip
spneumo_pangenome_k32	0.1	eulertigs	15	na	runsapprox	xz	663462	8925758	704049	8221709	628985	590164	8925758	2563380	2276568	189932	2466500	2675228	spneumo_pangenome_k32.r_0.1.S_eulertigs.k_15.d_na.M_runsapprox.C_xz
spneumo_pangenome_k32	0.2	eulertigs	15	na	default	bzip	1326925	15887023	1326925	14560098	1040007	1040007	15887023	4652628	4074784	173158	4247942	4797556	spneumo_pangenome_k32.r_0.2.S_eulertigs.k_15.d_na.M_default.C_bzip
spneumo_pangenome_k32	0.2	eulertigs	15	na	default	xz	1326925	15887023	1326925	14560098	1040007	1040007	15887023	4652628	4074784	270072	4344856	4797556	spneumo_pangenome_k32.r_0.2.S_eulertigs.k_15.d_na.M_default.C_xz
spneumo_pangenome_k32	0.2	eulertigs	15	na	ones	bzip	1326925	15887023	1470270	14416753	1170716	1040007	15887023	4652628	4074784	362462	4437246	4919500	spneumo_pangenome_k32.r_0.2.S_eulertigs.k_15.d_na.M_ones.C_bzip
spneumo_pangenome_k32	0.2	eulertigs	15	na	ones	xz	1326925	15887023	1470270	14416753	1170716	1040007	15887023	4652628	4074784	506428	4581212	4919500	spneumo_pangenome_k32.r_0.2.S_eulertigs.k_15.d_na.M_ones.C_xz
spneumo_pangenome_k32	0.2	eulertigs	15	na	runsapprox	bzip	1326925	15887023	1470270	14416753	1170716	1040007	15887023	4652628	4074784	362462	4437246	4919500	spneumo_pangenome_k32.r_0.2.S_eulertigs.k_15.d_na.M_runsapprox.C_bzip
spneumo_pangenome_k32	0.2	eulertigs	15	na	runsapprox	xz	1326925	15887023	1470270	14416753	1170716	1040007	15887023	4652628	4074784	506428	4581212	4919500	spneumo_pangenome_k32.r_0.2.S_eulertigs.k_15.d_na.M_runsapprox.C_xz
spneumo_pangenome_k32	0.3	eulertigs	15	na	default	bzip	1990388	20989984	1990388	18999596	1357114	1357114	20989984	6185596	5394652	300730	5695382	6416884	spneumo_pangenome_k32.r_0.3.S_eulertigs.k_15.d_na.M_default.C_bzip
spneumo_pangenome_k32	0.3	eulertigs	15	na	default	xz	1990388	20989984	1990388	18999596	1357114	1357114	20989984	6185596	5394652	458568	5853220	6416884	spneumo_pangenome_k32.r_0.3.S_eulertigs.k_15.d_na.M_default.C_xz
spneumo_pangenome_k32	0.3	eulertigs	15	na	ones	bzip	1990388	20989984	2270998	18718986	1600472	1357114	20989984	6185596	5394652	643888	6038540	6645496	spneumo_pangenome_k32.r_0.3.S_eulertigs.k_15.d_na.M_ones.C_bzip
spneumo_pangenome_k32	0.3	eulertigs	15	na	ones	xz	1990388	20989984	2270998	18718986	1600472	1357114	20989984	6185596	5394652	829200	6223852	6645496	spneumo_pangenome_k32.r_0.3.S_eulertigs.k_15.d_na.M_ones.C_xz
spneumo_pangenome_k32	0.3	eulertigs	15	na	runsapprox	bzip	1990388	20989984	2270998	18718986	1600472	1357114	20989984	6185596	5394652	643888	6038540	6645496	spneumo_pangenome_k32.r_0.3.S_eulertigs.k_15.d_na.M_runsapprox.C_bzip
spneumo_pangenome_k32	0.3	eulertigs	15	na	runsapprox	xz	1990388	20989984	2270998	18718986	1600472	1357114	20989984	6185596	5394652	829200	6223852	6645496	spneumo_pangenome_k32.r_0.3.S_eulertigs.k_15.d_na.M_runsapprox.C_xz
spneumo_pangenome_k32	0.4	eulertigs	15	na	default	bzip	2653851	24339571	2653851	21685720	1548980	1548980	24339571	7187508	6252276	426557	6678833	7506716	spneumo_pangenome_k32.r_0.4.S_eulertigs.k_15.d_na.M_default.C_bzip
spneumo_pangenome_k32	0.4	eulertigs	15	na	default	xz	2653851	24339571	2653851	21685720	1548980	1548980	24339571	7187508	6252276	629196	6881472	7506716	spneumo_pangenome_k32.r_0.4.S_eulertigs.k_15.d_na.M_default.C_xz
spneumo_pangenome_k32	0.4	eulertigs	15	na	ones	bzip	2653851	24339571	3086008	21253563	1903657	1548980	24339571	7187508	6252276	919647	7171923	7851128	spneumo_pangenome_k32.r_0.4.S_eulertigs.k_15.d_na.M_ones.C_bzip
spneumo_pangenome_k32	0.4	eulertigs	15	na	ones	xz	2653851	24339571	3086008	21253563	1903657	1548980	24339571	7187508	6252276	1116336	7368612	7851128	spneumo_pangenome_k32.r_0.4.S_eulertigs.k_15.d_na.M_ones.C_xz
spneumo_pangenome_k32	0.4	eulertigs	15	na	runsapprox	bzip	2653851	24339571	3086008	21253563	1903657	1548980	24339571	7187508	6252276	919647	7171923	7851128	spneumo_pangenome_k32.r_0.4.S_eulertigs.k_15.d_na.M_runsapprox.C_bzip
spneumo_pangenome_k32	0.4	eulertigs	15	na	runsapprox	xz	2653851	24339571	3086008	21253563	1903657	1548980	24339571	7187508	6252276	1116336	7368612	7851128	spneumo_pangenome_k32.r_0.4.S_eulertigs.k_15.d_na.M_runsapprox.C_xz
spneumo_pangenome_k32	0.5	eulertigs	15	na	default	bzip	3317314	26004160	3317314	22686846	1620489	1620489	26004160	7673392	6666012	538572	7204584	8074208	spneumo_pangenome_k32.r_0.5.S_eulertigs.k_15.d_na.M_default.C_bzip
spneumo_pangenome_k32	0.5	eulertigs	15	na	default	xz	3317314	26004160	3317314	22686846	1620489	1620489	26004160	7673392	6666012	762864	7428876	8074208	spneumo_pangenome_k32.r_0.5.S_eulertigs.k_15.d_na.M_default.C_xz
spneumo_pangenome_k32	0.5	eulertigs	15	na	ones	bzip	3317314	26004160	3894477	22109683	2067188	1620489	26004160	7673392	6666012	1162230	7828242	8525760	spneumo_pangenome_k32.r_0.5.S_eulertigs.k_15.d_na.M_ones.C_bzip
spneumo_pangenome_k32	0.5	eulertigs	15	na	ones	xz	3317314	26004160	3894477	22109683	2067188	1620489	26004160	7673392	6666012	1340140	8006152	8525760	spneumo_pangenome_k32.r_0.5.S_eulertigs.k_15.d_na.M_ones.C_xz
spneumo_pangenome_k32	0.5	eulertigs	15	na	runsapprox	bzip	3317314	26004160	3894477	22109683	2067188	1620489	26004160	7673392	6666012	1162230	7828242	8525760	spneumo_pangenome_k32.r_0.5.S_eulertigs.k_15.d_na.M_runsapprox.C_bzip
spneumo_pangenome_k32	0.5	eulertigs	15	na	runsapprox	xz	3317314	26004160	3894477	22109683	2067188	1620489	26004160	7673392	6666012	1340140	8006152	8525760	spneumo_pangenome_k32.r_0.5.S_eulertigs.k_15.d_na.M_runsapprox.C_xz
spneumo_pangenome_k32	0.6	eulertigs	15	na	default	bzip	3980776	26020752	3980776	22039976	1574284	1574284	26020752	7671936	6662456	619732	7282188	8136836	spneumo_pangenome_k32.r_0.6.S_eulertigs.k_15.d_na.M_default.C_bzip
spneumo_pangenome_k32	0.6	eulertigs	15	na	default	xz	3980776	26020752	3980776	22039976	1574284	1574284	26020752	7671936	6662456	842960	7505416	8136836	spneumo_pangenome_k32.r_0.6.S_eulertigs.k_15.d_na.M_default.C_xz
spneumo_pangenome_k32	0.6	eulertigs	15	na	ones	bzip	3980776	26020752	4667708	21353044	2070472	1574284	26020752	7671936	6662456	1315406	7977862	8636052	spneumo_pangenome_k32.r_0.6.S_eulertigs.k_15.d_na.M_ones.C_bzip
spneumo_pangenome_k32	0.6	eulertigs	15	na	ones	xz	3980776	26020752	4667708	21353044	2070472	1574284	26020752	7671936	6662456	1471204	8133660	8636052	spneumo_pangenome_k32.r_0.6.S_eulertigs.k_15.d_na.M_ones.C_xz
spneumo_pangenome_k32	0.6	eulertigs	15	na	runsapprox	bzip	3980776	26020752	4667708	21353044	2070472	1574284	26020752	7671936	6662456	1315406	7977862	8636052	spneumo_pangenome_k32.r_0.6.S_eulertigs.k_15.d_na.M_runsapprox.C_bzip
spneumo_pangenome_k32	0.6	eulertigs	15	na	runsapprox	xz	3980776	26020752	4667708	21353044	2070472	1574284	26020752	7671936	6662456	1471204	8133660	8636052	spneumo_pangenome_k32.r_0.6.S_eulertigs.k_15.d_na.M_runsapprox.C_xz
spneumo_pangenome_k32	0.7	eulertigs	15	na	default	bzip	4644239	24445111	4644239	19800872	1414348	1414348	24445111	7190492	6249944	649767	6899711	7718248	spneumo_pangenome_k32.r_0.7.S_eulertigs.k_15.d_na.M_default.C_bzip
spneumo_pangenome_k32	0.7	eulertigs	15	na	default	xz	4644239	24445111	4644239	19800872	1414348	1414348	24445111	7190492	6249944	850912	7100856	7718248	spneumo_pangenome_k32.r_0.7.S_eulertigs.k_15.d_na.M_default.C_xz
spneumo_pangenome_k32	0.7	eulertigs	15	na	ones	bzip	4644239	24445111	5389359	19055752	1909235	1414348	24445111	7190492	6249944	1357551	7607495	8287344	spneumo_pangenome_k32.r_0.7.S_eulertigs.k_15.d_na.M_ones.C_bzip
spneumo_pangenome_k32	0.7	eulertigs	15	na	ones	xz	4644239	24445111	5389359	19055752	1909235	1414348	24445111	7190492	6249944	1489620	7739564	8287344	spneumo_pangenome_k32.r_0.7.S_eulertigs.k_15.d_na.M_ones.C_xz
spneumo_pangenome_k32	0.7	eulertigs	15	na	runsapprox	bzip	4644239	24445111	5389359	19055752	1909235	1414348	24445111	7190492	6249944	1357551	7607495	8287344	spneumo_pangenome_k32.r_0.7.S_eulertigs.k_15.d_na.M_runsapprox.C_bzip
spneumo_pangenome_k32	0.7	eulertigs	15	na	runsapprox	xz	4644239	24445111	5389359	19055752	1909235	1414348	24445111	7190492	6249944	1489620	7739564	8287344	spneumo_pangenome_k32.r_0.7.S_eulertigs.k_15.d_na.M_runsapprox.C_xz
spneumo_pangenome_k32	0.8	eulertigs	15	na	default	bzip	5307702	21271888	5307702	15964186	1140299	1140299	21271888	6227756	5433208	615464	6048672	6818852	spneumo_pangenome_k32.r_0.8.S_eulertigs.k_15.d_na.M_default.C_bzip
spneumo_pangenome_k32	0.8	eulertigs	15	na	default	xz	5307702	21271888	5307702	15964186	1140299	1140299	21271888	6227756	5433208	773740	6206948	6818852	spneumo_pangenome_k32.r_0.8.S_eulertigs.k_15.d_na.M_default.C_xz
spneumo_pangenome_k32	0.8	eulertigs	15	na	ones	bzip	5307702	21271888	6036778	15235110	1573547	1140299	21271888	6227756	5433208	1254115	6687323	7248972	spneumo_pangenome_k32.r_0.8.S_eulertigs.k_15.d_na.M_ones.C_bzip
spneumo_pangenome_k32	0.8	eulertigs	15	na	ones	xz	5307702	21271888	6036778	15235110	1573547	1140299	21271888	6227756	5433208	1366696	6799904	7248972	spneumo_pangenome_k32.r_0.8.S_eulertigs.k_15.d_na.M_ones.C_xz
spneumo_pangenome_k32	0.8	eulertigs	15	na	runsapprox	bzip	5307702	21271888	6036778	15235110	1573547	1140299	21271888	6227756	5433208	1254115	6687323	7248972	spneumo_pangenome_k32.r_0.8.S_eulertigs.k_15.d_na.M_runsapprox.C_bzip
spneumo_pangenome_k32	0.8	eulertigs	15	na	runsapprox	xz	5307702	21271888	6036778	15235110	1573547	1140299	21271888	6227756	5433208	1366696	6799904	7248972	spneumo_pangenome_k32.r_0.8.S_eulertigs.k_15.d_na.M_runsapprox.C_xz
spneumo_pangenome_k32	0.9	eulertigs	15	na	default	bzip	5971165	16493845	5971165	10522680	751620	751620	16493845	4775712	4212184	481299	4693483	5291712	spneumo_pangenome_k32.r_0.9.S_eulertigs.k_15.d_na.M_default.C_bzip
spneumo_pangenome_k32	0.9	eulertigs	15	na	default	xz	5971165	16493845	5971165	10522680	751620	751620	16493845	4775712	4212184	608348	4820532	5291712	spneumo_pangenome_k32.r_0.9.S_eulertigs.k_15.d_na.M_default.C_xz
spneumo_pangenome_k32	0.9	eulertigs	15	na	ones	bzip	5971165	16493845	6585181	9908664	1051872	751620	16493845	4775712	4212184	960067	5172251	5570492	spneumo_pangenome_k32.r_0.9.S_eulertigs.k_15.d_na.M_ones.C_bzip
spneumo_pangenome_k32	0.9	eulertigs	15	na	ones	xz	5971165	16493845	6585181	9908664	1051872	751620	16493845	4775712	4212184	1063872	5276056	5570492	spneumo_pangenome_k32.r_0.9.S_eulertigs.k_15.d_na.M_ones.C_xz
spneumo_pangenome_k32	0.9	eulertigs	15	na	runsapprox	bzip	5971165	16493845	6585181	9908664	1051872	751620	16493845	4775712	4212184	960067	5172251	5570492	spneumo_pangenome_k32.r_0.9.S_eulertigs.k_15.d_na.M_runsapprox.C_bzip
spneumo_pangenome_k32	0.9	eulertigs	15	na	runsapprox	xz	5971165	16493845	6585181	9908664	1051872	751620	16493845	4775712	4212184	1063872	5276056	5570492	spneumo_pangenome_k32.r_0.9.S_eulertigs.k_15.d_na.M_runsapprox.C_xz
spneumo_pangenome_k32	1.0	eulertigs	15	na	default	bzip	6634628	10112774	6634628	3478146	248439	248439	10112774	2748268	2531856	207821	2739677	3020304	spneumo_pangenome_k32.r_1.0.S_eulertigs.k_15.d_na.M_default.C_bzip
spneumo_pangenome_k32	1.0	eulertigs	15	na	default	xz	6634628	10112774	6634628	3478146	248439	248439	10112774	2748268	2531856	308224	2840080	3020304	spneumo_pangenome_k32.r_1.0.S_eulertigs.k_15.d_na.M_default.C_xz
spneumo_pangenome_k32	1.0	eulertigs	15	na	ones	bzip	6634628	10112774	7015753	3097021	339936	248439	10112774	2748268	2531856	398921	2930777	3124860	spneumo_pangenome_k32.r_1.0.S_eulertigs.k_15.d_na.M_ones.C_bzip
spneumo_pangenome_k32	1.0	eulertigs	15	na	ones	xz	6634628	10112774	7015753	3097021	339936	248439	10112774	2748268	2531856	493964	3025820	3124860	spneumo_pangenome_k32.r_1.0.S_eulertigs.k_15.d_na.M_ones.C_xz
spneumo_pangenome_k32	1.0	eulertigs	15	na	runsapprox	bzip	6634628	10112774	7015753	3097021	339936	248439	10112774	2748268	2531856	398921	2930777	3124860	spneumo_pangenome_k32.r_1.0.S_eulertigs.k_15.d_na.M_runsapprox.C_bzip
spneumo_pangenome_k32	1.0	eulertigs	15	na	runsapprox	xz	6634628	10112774	7015753	3097021	339936	248439	10112774	2748268	2531856	493964	3025820	3124860	spneumo_pangenome_k32.r_1.0.S_eulertigs.k_15.d_na.M_runsapprox.C_xz
spneumo_pangenome_k32	0.000000001	greedytigs	15	na	default	bzip	1	15	1	14	1	1	15	80	80	41	121	80	spneumo_pangenome_k32.r_0.000000001.S_greedytigs.k_15.d_na.M_default.C_bzip
spneumo_pangenome_k32	0.000000001	greedytigs	15	na	default	xz	1	15	1	14	1	1	15	80	80	76	156	80	spneumo_pangenome_k32.r_0.000000001.S_greedytigs.k_15.d_na.M_default.C_xz
spneumo_pangenome_k32	0.000000001	greedytigs	15	na	ones	bzip	1	15	1	14	1	1	15	80	80	41	121	80	spneumo_pangenome_k32.r_0.000000001.S_greedytigs.k_15.d_na.M_ones.C_bzip
spneumo_pangenome_k32	0.000000001	greedytigs	15	na	ones	xz	1	15	1	14	1	1	15	80	80	76	156	80	spneumo_pangenome_k32.r_0.000000001.S_greedytigs.k_15.d_na.M_ones.C_xz
spneumo_pangenome_k32	0.000000001	greedytigs	15	na	runsapprox	bzip	1	15	1	14	1	1	15	80	80	41	121	80	spneumo_pangenome_k32.r_0.000000001.S_greedytigs.k_15.d_na.M_runsapprox.C_bzip
spneumo_pangenome_k32	0.000000001	greedytigs	15	na	runsapprox	xz	1	15	1	14	1	1	15	80	80	76	156	80	spneumo_pangenome_k32.r_0.000000001.S_greedytigs.k_15.d_na.M_runsapprox.C_xz
spneumo_pangenome_k32	0.0001	greedytigs	15	na	default	bzip	663	9945	663	9282	663	663	9945	3116	2924	47	2971	3104	spneumo_pangenome_k32.r_0.0001.S_greedytigs.k_15.d_na.M_default.C_bzip
spneumo_pangenome_k32	0.0001	greedytigs	15	na	default	xz	663	9945	663	9282	663	663	9945	3116	2924	120	3044	3104	spneumo_pangenome_k32.r_0.0001.S_greedytigs.k_15.d_na.M_default.C_xz
spneumo_pangenome_k32	0.0001	greedytigs	15	na	ones	bzip	663	9945	663	9282	663	663	9945	3116	2924	47	2971	3104	spneumo_pangenome_k32.r_0.0001.S_greedytigs.k_15.d_na.M_ones.C_bzip
spneumo_pangenome_k32	0.0001	greedytigs	15	na	ones	xz	663	9945	663	9282	663	663	9945	3116	2924	120	3044	3104	spneumo_pangenome_k32.r_0.0001.S_greedytigs.k_15.d_na.M_ones.C_xz
spneumo_pangenome_k32	0.0001	greedytigs	15	na	runsapprox	bzip	663	9945	663	9282	663	663	9945	3116	2924	47	2971	3104	spneumo_pangenome_k32.r_0.0001.S_greedytigs.k_15.d_na.M_runsapprox.C_bzip
spneumo_pangenome_k32	0.0001	greedytigs	15	na	runsapprox	xz	663	9945	663	9282	663	663	9945	3116	2924	120	3044	3104	spneumo_pangenome_k32.r_0.0001.S_greedytigs.k_15.d_na.M_runsapprox.C_xz
spneumo_pangenome_k32	0.001	greedytigs	15	na	default	bzip	6634	99454	6634	92820	6630	6630	99454	26952	26000	56	26056	28624	spneumo_pangenome_k32.r_0.001.S_greedytigs.k_15.d_na.M_default.C_bzip
spneumo_pangenome_k32	0.001	greedytigs	15	na	default	xz	6634	99454	6634	92820	6630	6630	99454	26952	26000	180	26180	28624	spneumo_pangenome_k32.r_0.001.S_greedytigs.k_15.d_na.M_default.C_xz
spneumo_pangenome_k32	0.001	greedytigs	15	na	ones	bzip	6634	99454	6639	92815	6635	6630	99454	26952	26000	74	26074	28572	spneumo_pangenome_k32.r_0.001.S_greedytigs.k_15.d_na.M_ones.C_bzip
spneumo_pangenome_k32	0.001	greedytigs	15	na	ones	xz	6634	99454	6639	92815	6635	6630	99454	26952	26000	208	26208	28572	spneumo_pangenome_k32.r_0.001.S_greedytigs.k_15.d_na.M_ones.C_xz
spneumo_pangenome_k32	0.001	greedytigs	15	na	runsapprox	bzip	6634	99454	6639	92815	6635	6630	99454	26952	26000	74	26074	28572	spneumo_pangenome_k32.r_0.001.S_greedytigs.k_15.d_na.M_runsapprox.C_bzip
spneumo_pangenome_k32	0.001	greedytigs	15	na	runsapprox	xz	6634	99454	6639	92815	6635	6630	99454	26952	26000	208	26208	28572	spneumo_pangenome_k32.r_0.001.S_greedytigs.k_15.d_na.M_runsapprox.C_xz
spneumo_pangenome_k32	0.01	greedytigs	15	na	default	bzip	66346	985054	66346	918708	65622	65622	985054	273236	255056	1284	256340	281580	spneumo_pangenome_k32.r_0.01.S_greedytigs.k_15.d_na.M_default.C_bzip
spneumo_pangenome_k32	0.01	greedytigs	15	na	default	xz	66346	985054	66346	918708	65622	65622	985054	273236	255056	2276	257332	281580	spneumo_pangenome_k32.r_0.01.S_greedytigs.k_15.d_na.M_default.C_xz
spneumo_pangenome_k32	0.01	greedytigs	15	na	ones	bzip	66346	985054	66825	918229	66093	65622	985054	273236	255056	2304	257360	282100	spneumo_pangenome_k32.r_0.01.S_greedytigs.k_15.d_na.M_ones.C_bzip
spneumo_pangenome_k32	0.01	greedytigs	15	na	ones	xz	66346	985054	66825	918229	66093	65622	985054	273236	255056	4256	259312	282100	spneumo_pangenome_k32.r_0.01.S_greedytigs.k_15.d_na.M_ones.C_xz
spneumo_pangenome_k32	0.01	greedytigs	15	na	runsapprox	bzip	66346	985054	66825	918229	66093	65622	985054	273236	255056	2304	257360	282100	spneumo_pangenome_k32.r_0.01.S_greedytigs.k_15.d_na.M_runsapprox.C_bzip
spneumo_pangenome_k32	0.01	greedytigs	15	na	runsapprox	xz	66346	985054	66825	918229	66093	65622	985054	273236	255056	4256	259312	282100	spneumo_pangenome_k32.r_0.01.S_greedytigs.k_15.d_na.M_runsapprox.C_xz
spneumo_pangenome_k32	0.05	greedytigs	15	na	default	bzip	331731	4717875	331731	4386144	313296	313296	4717875	1336556	1202964	21245	1224209	1364236	spneumo_pangenome_k32.r_0.05.S_greedytigs.k_15.d_na.M_default.C_bzip
spneumo_pangenome_k32	0.05	greedytigs	15	na	default	xz	331731	4717875	331731	4386144	313296	313296	4717875	1336556	1202964	33612	1236576	1364236	spneumo_pangenome_k32.r_0.05.S_greedytigs.k_15.d_na.M_default.C_xz
spneumo_pangenome_k32	0.05	greedytigs	15	na	ones	bzip	331731	4717875	342628	4375247	323946	313296	4717875	1336556	1202964	39087	1242051	1376404	spneumo_pangenome_k32.r_0.05.S_greedytigs.k_15.d_na.M_ones.C_bzip
spneumo_pangenome_k32	0.05	greedytigs	15	na	ones	xz	331731	4717875	342628	4375247	323946	313296	4717875	1336556	1202964	63964	1266928	1376404	spneumo_pangenome_k32.r_0.05.S_greedytigs.k_15.d_na.M_ones.C_xz
spneumo_pangenome_k32	0.05	greedytigs	15	na	runsapprox	bzip	331731	4717875	342628	4375247	323946	313296	4717875	1336556	1202964	39087	1242051	1376404	spneumo_pangenome_k32.r_0.05.S_greedytigs.k_15.d_na.M_runsapprox.C_bzip
spneumo_pangenome_k32	0.05	greedytigs	15	na	runsapprox	xz	331731	4717875	342628	4375247	323946	313296	4717875	1336556	1202964	63964	1266928	1376404	spneumo_pangenome_k32.r_0.05.S_greedytigs.k_15.d_na.M_runsapprox.C_xz
spneumo_pangenome_k32	0.1	greedytigs	15	na	default	bzip	663462	8925706	663466	8262240	590160	590160	8925706	2561904	2277460	63071	2340531	2636212	spneumo_pangenome_k32.r_0.1.S_greedytigs.k_15.d_na.M_default.C_bzip
spneumo_pangenome_k32	0.1	greedytigs	15	na	default	xz	663462	8925706	663466	8262240	590160	590160	8925706	2561904	2277460	98056	2375516	2636212	spneumo_pangenome_k32.r_0.1.S_greedytigs.k_15.d_na.M_default.C_xz
spneumo_pangenome_k32	0.1	greedytigs	15	na	ones	bzip	663462	8925706	704295	8221411	629159	590160	8925706	2561904	2277460	123669	2401129	2676940	spneumo_pangenome_k32.r_0.1.S_greedytigs.k_15.d_na.M_ones.C_bzip
spneumo_pangenome_k32	0.1	greedytigs	15	na	ones	xz	663462	8925706	704295	8221411	629159	590160	8925706	2561904	2277460	190156	2467616	2676940	spneumo_pangenome_k32.r_0.1.S_greedytigs.k_15.d_na.M_ones.C_xz
spneumo_pangenome_k32	0.1	greedytigs	15	na	runsapprox	bzip	663462	8925706	704295	8221411	629159	590160	8925706	2561904	2277460	123669	2401129	2676940	spneumo_pangenome_k32.r_0.1.S_greedytigs.k_15.d_na.M_runsapprox.C_bzip
spneumo_pangenome_k32	0.1	greedytigs	15	na	runsapprox	xz	663462	8925706	704295	8221411	629159	590160	8925706	2561904	2277460	190156	2467616	2676940	spneumo_pangenome_k32.r_0.1.S_greedytigs.k_15.d_na.M_runsapprox.C_xz
spneumo_pangenome_k32	0.2	greedytigs	15	na	default	bzip	1326925	15885653	1327053	14558600	1039900	1039900	15885653	4650796	4073516	173405	4246921	4793220	spneumo_pangenome_k32.r_0.2.S_greedytigs.k_15.d_na.M_default.C_bzip
spneumo_pangenome_k32	0.2	greedytigs	15	na	default	xz	1326925	15885653	1327053	14558600	1039900	1039900	15885653	4650796	4073516	270360	4343876	4793220	spneumo_pangenome_k32.r_0.2.S_greedytigs.k_15.d_na.M_default.C_xz
spneumo_pangenome_k32	0.2	greedytigs	15	na	ones	bzip	1326925	15885653	1469618	14416035	1170183	1039900	15885653	4650796	4073516	361824	4435340	4905464	spneumo_pangenome_k32.r_0.2.S_greedytigs.k_15.d_na.M_ones.C_bzip
spneumo_pangenome_k32	0.2	greedytigs	15	na	ones	xz	1326925	15885653	1469618	14416035	1170183	1039900	15885653	4650796	4073516	505576	4579092	4905464	spneumo_pangenome_k32.r_0.2.S_greedytigs.k_15.d_na.M_ones.C_xz
spneumo_pangenome_k32	0.2	greedytigs	15	na	runsapprox	bzip	1326925	15885653	1469618	14416035	1170183	1039900	15885653	4650796	4073516	361824	4435340	4905464	spneumo_pangenome_k32.r_0.2.S_greedytigs.k_15.d_na.M_runsapprox.C_bzip
spneumo_pangenome_k32	0.2	greedytigs	15	na	runsapprox	xz	1326925	15885653	1469618	14416035	1170183	1039900	15885653	4650796	4073516	505576	4579092	4905464	spneumo_pangenome_k32.r_0.2.S_greedytigs.k_15.d_na.M_runsapprox.C_xz
spneumo_pangenome_k32	0.3	greedytigs	15	na	default	bzip	1990388	20980871	1991481	18989390	1356385	1356385	20980871	6181604	5389800	301128	5690928	6413332	spneumo_pangenome_k32.r_0.3.S_greedytigs.k_15.d_na.M_default.C_bzip
spneumo_pangenome_k32	0.3	greedytigs	15	na	default	xz	1990388	20980871	1991481	18989390	1356385	1356385	20980871	6181604	5389800	459000	5848800	6413332	spneumo_pangenome_k32.r_0.3.S_greedytigs.k_15.d_na.M_default.C_xz
spneumo_pangenome_k32	0.3	greedytigs	15	na	ones	bzip	1990388	20980871	2270737	18710134	1599130	1356385	20980871	6181604	5389800	642976	6032776	6641476	spneumo_pangenome_k32.r_0.3.S_greedytigs.k_15.d_na.M_ones.C_bzip
spneumo_pangenome_k32	0.3	greedytigs	15	na	ones	xz	1990388	20980871	2270737	18710134	1599130	1356385	20980871	6181604	5389800	827652	6217452	6641476	spneumo_pangenome_k32.r_0.3.S_greedytigs.k_15.d_na.M_ones.C_xz
spneumo_pangenome_k32	0.3	greedytigs	15	na	runsapprox	bzip	1990388	20980871	2270737	18710134	1599130	1356385	20980871	6181604	5389800	642976	6032776	6641476	spneumo_pangenome_k32.r_0.3.S_greedytigs.k_15.d_na.M_runsapprox.C_bzip
spneumo_pangenome_k32	0.3	greedytigs	15	na	runsapprox	xz	1990388	20980871	2270737	18710134	1599130	1356385	20980871	6181604	5389800	827652	6217452	6641476	spneumo_pangenome_k32.r_0.3.S_greedytigs.k_15.d_na.M_runsapprox.C_xz
spneumo_pangenome_k32	0.4	greedytigs	15	na	default	bzip	2653851	24307281	2658269	21649012	1546358	1546358	24307281	7179152	6246568	427462	6674030	7492020	spneumo_pangenome_k32.r_0.4.S_greedytigs.k_15.d_na.M_default.C_bzip
spneumo_pangenome_k32	0.4	greedytigs	15	na	default	xz	2653851	24307281	2658269	21649012	1546358	1546358	24307281	7179152	6246568	630432	6877000	7492020	spneumo_pangenome_k32.r_0.4.S_greedytigs.k_15.d_na.M_default.C_xz
spneumo_pangenome_k32	0.4	greedytigs	15	na	ones	bzip	2653851	24307281	3087409	21219872	1900278	1546358	24307281	7179152	6246568	918400	7164968	7843524	spneumo_pangenome_k32.r_0.4.S_greedytigs.k_15.d_na.M_ones.C_bzip
spneumo_pangenome_k32	0.4	greedytigs	15	na	ones	xz	2653851	24307281	3087409	21219872	1900278	1546358	24307281	7179152	6246568	1114728	7361296	7843524	spneumo_pangenome_k32.r_0.4.S_greedytigs.k_15.d_na.M_ones.C_xz
spneumo_pangenome_k32	0.4	greedytigs	15	na	runsapprox	bzip	2653851	24307281	3087409	21219872	1900278	1546358	24307281	7179152	6246568	918400	7164968	7843524	spneumo_pangenome_k32.r_0.4.S_greedytigs.k_15.d_na.M_runsapprox.C_bzip
spneumo_pangenome_k32	0.4	greedytigs	15	na	runsapprox	xz	2653851	24307281	3087409	21219872	1900278	1546358	24307281	7179152	6246568	1114728	7361296	7843524	spneumo_pangenome_k32.r_0.4.S_greedytigs.k_15.d_na.M_runsapprox.C_xz
spneumo_pangenome_k32	0.5	greedytigs	15	na	default	bzip	3317314	25919317	3331479	22587838	1613417	1613417	25919317	7655240	6649484	540700	7190184	8052360	spneumo_pangenome_k32.r_0.5.S_greedytigs.k_15.d_na.M_default.C_bzip
spneumo_pangenome_k32	0.5	greedytigs	15	na	default	xz	3317314	25919317	3331479	22587838	1613417	1613417	25919317	7655240	6649484	764564	7414048	8052360	spneumo_pangenome_k32.r_0.5.S_greedytigs.k_15.d_na.M_default.C_xz
spneumo_pangenome_k32	0.5	greedytigs	15	na	ones	bzip	3317314	25919317	3897814	22021503	2056105	1613417	25919317	7655240	6649484	1154918	7804402	8494496	spneumo_pangenome_k32.r_0.5.S_greedytigs.k_15.d_na.M_ones.C_bzip
spneumo_pangenome_k32	0.5	greedytigs	15	na	ones	xz	3317314	25919317	3897814	22021503	2056105	1613417	25919317	7655240	6649484	1333672	7983156	8494496	spneumo_pangenome_k32.r_0.5.S_greedytigs.k_15.d_na.M_ones.C_xz
spneumo_pangenome_k32	0.5	greedytigs	15	na	runsapprox	bzip	3317314	25919317	3897814	22021503	2056105	1613417	25919317	7655240	6649484	1154918	7804402	8494496	spneumo_pangenome_k32.r_0.5.S_greedytigs.k_15.d_na.M_runsapprox.C_bzip
spneumo_pangenome_k32	0.5	greedytigs	15	na	runsapprox	xz	3317314	25919317	3897814	22021503	2056105	1613417	25919317	7655240	6649484	1333672	7983156	8494496	spneumo_pangenome_k32.r_0.5.S_greedytigs.k_15.d_na.M_runsapprox.C_xz
spneumo_pangenome_k32	0.6	greedytigs	15	na	default	bzip	3980776	25834426	4021432	21812994	1558071	1558071	25834426	7625992	6624204	622444	7246648	8094456	spneumo_pangenome_k32.r_0.6.S_greedytigs.k_15.d_na.M_default.C_bzip
spneumo_pangenome_k32	0.6	greedytigs	15	na	default	xz	3980776	25834426	4021432	21812994	1558071	1558071	25834426	7625992	6624204	842928	7467132	8094456	spneumo_pangenome_k32.r_0.6.S_greedytigs.k_15.d_na.M_default.C_xz
spneumo_pangenome_k32	0.6	greedytigs	15	na	ones	bzip	3980776	25834426	4680798	21153628	2044999	1558071	25834426	7625992	6624204	1297672	7921876	8581256	spneumo_pangenome_k32.r_0.6.S_greedytigs.k_15.d_na.M_ones.C_bzip
spneumo_pangenome_k32	0.6	greedytigs	15	na	ones	xz	3980776	25834426	4680798	21153628	2044999	1558071	25834426	7625992	6624204	1454472	8078676	8581256	spneumo_pangenome_k32.r_0.6.S_greedytigs.k_15.d_na.M_ones.C_xz
spneumo_pangenome_k32	0.6	greedytigs	15	na	runsapprox	bzip	3980776	25834426	4680798	21153628	2044999	1558071	25834426	7625992	6624204	1297672	7921876	8581256	spneumo_pangenome_k32.r_0.6.S_greedytigs.k_15.d_na.M_runsapprox.C_bzip
spneumo_pangenome_k32	0.6	greedytigs	15	na	runsapprox	xz	3980776	25834426	4680798	21153628	2044999	1558071	25834426	7625992	6624204	1454472	8078676	8581256	spneumo_pangenome_k32.r_0.6.S_greedytigs.k_15.d_na.M_runsapprox.C_xz
spneumo_pangenome_k32	0.7	greedytigs	15	na	default	bzip	4644239	24085297	4749561	19335736	1381124	1381124	24085297	7095440	6173616	651886	6825502	7625276	spneumo_pangenome_k32.r_0.7.S_greedytigs.k_15.d_na.M_default.C_bzip
spneumo_pangenome_k32	0.7	greedytigs	15	na	default	xz	4644239	24085297	4749561	19335736	1381124	1381124	24085297	7095440	6173616	844864	7018480	7625276	spneumo_pangenome_k32.r_0.7.S_greedytigs.k_15.d_na.M_default.C_xz
spneumo_pangenome_k32	0.7	greedytigs	15	na	ones	bzip	4644239	24085297	5438974	18646323	1858645	1381124	24085297	7095440	6173616	1321843	7495459	8168140	spneumo_pangenome_k32.r_0.7.S_greedytigs.k_15.d_na.M_ones.C_bzip
spneumo_pangenome_k32	0.7	greedytigs	15	na	ones	xz	4644239	24085297	5438974	18646323	1858645	1381124	24085297	7095440	6173616	1453896	7627512	8168140	spneumo_pangenome_k32.r_0.7.S_greedytigs.k_15.d_na.M_ones.C_xz
spneumo_pangenome_k32	0.7	greedytigs	15	na	runsapprox	bzip	4644239	24085297	5438974	18646323	1858645	1381124	24085297	7095440	6173616	1321843	7495459	8168140	spneumo_pangenome_k32.r_0.7.S_greedytigs.k_15.d_na.M_runsapprox.C_bzip
spneumo_pangenome_k32	0.7	greedytigs	15	na	runsapprox	xz	4644239	24085297	5438974	18646323	1858645	1381124	24085297	7095440	6173616	1453896	7627512	8168140	spneumo_pangenome_k32.r_0.7.S_greedytigs.k_15.d_na.M_runsapprox.C_xz
spneumo_pangenome_k32	0.8	greedytigs	15	na	default	bzip	5307702	20652572	5565766	15086806	1077629	1077629	20652572	6052028	5291592	603551	5895143	6648696	spneumo_pangenome_k32.r_0.8.S_greedytigs.k_15.d_na.M_default.C_bzip
spneumo_pangenome_k32	0.8	greedytigs	15	na	default	xz	5307702	20652572	5565766	15086806	1077629	1077629	20652572	6052028	5291592	754560	6046152	6648696	spneumo_pangenome_k32.r_0.8.S_greedytigs.k_15.d_na.M_default.C_xz
spneumo_pangenome_k32	0.8	greedytigs	15	na	ones	bzip	5307702	20652572	6185765	14466807	1477339	1077629	20652572	6052028	5291592	1175236	6466828	7025964	spneumo_pangenome_k32.r_0.8.S_greedytigs.k_15.d_na.M_ones.C_bzip
spneumo_pangenome_k32	0.8	greedytigs	15	na	ones	xz	5307702	20652572	6185765	14466807	1477339	1077629	20652572	6052028	5291592	1294452	6586044	7025964	spneumo_pangenome_k32.r_0.8.S_greedytigs.k_15.d_na.M_ones.C_xz
spneumo_pangenome_k32	0.8	greedytigs	15	na	runsapprox	bzip	5307702	20652572	6185765	14466807	1477339	1077629	20652572	6052028	5291592	1175236	6466828	7025964	spneumo_pangenome_k32.r_0.8.S_greedytigs.k_15.d_na.M_runsapprox.C_bzip
spneumo_pangenome_k32	0.8	greedytigs	15	na	runsapprox	xz	5307702	20652572	6185765	14466807	1477339	1077629	20652572	6052028	5291592	1294452	6586044	7025964	spneumo_pangenome_k32.r_0.8.S_greedytigs.k_15.d_na.M_runsapprox.C_xz
spneumo_pangenome_k32	0.9	greedytigs	15	na	default	bzip	5971165	15512166	6562526	8949640	639260	639260	15512166	4460276	3961016	440398	4401414	4940960	spneumo_pangenome_k32.r_0.9.S_greedytigs.k_15.d_na.M_default.C_bzip
spneumo_pangenome_k32	0.9	greedytigs	15	na	default	xz	5971165	15512166	6562526	8949640	639260	639260	15512166	4460276	3961016	567560	4528576	4940960	spneumo_pangenome_k32.r_0.9.S_greedytigs.k_15.d_na.M_default.C_xz
spneumo_pangenome_k32	0.9	greedytigs	15	na	ones	bzip	5971165	15512166	6981975	8530191	883755	639260	15512166	4460276	3961016	808537	4769553	5179284	spneumo_pangenome_k32.r_0.9.S_greedytigs.k_15.d_na.M_ones.C_bzip
spneumo_pangenome_k32	0.9	greedytigs	15	na	ones	xz	5971165	15512166	6981975	8530191	883755	639260	15512166	4460276	3961016	926624	4887640	5179284	spneumo_pangenome_k32.r_0.9.S_greedytigs.k_15.d_na.M_ones.C_xz
spneumo_pangenome_k32	0.9	greedytigs	15	na	runsapprox	bzip	5971165	15512166	6981975	8530191	883755	639260	15512166	4460276	3961016	808537	4769553	5179284	spneumo_pangenome_k32.r_0.9.S_greedytigs.k_15.d_na.M_runsapprox.C_bzip
spneumo_pangenome_k32	0.9	greedytigs	15	na	runsapprox	xz	5971165	15512166	6981975	8530191	883755	639260	15512166	4460276	3961016	926624	4887640	5179284	spneumo_pangenome_k32.r_0.9.S_greedytigs.k_15.d_na.M_runsapprox.C_xz
spneumo_pangenome_k32	1.0	greedytigs	15	na	default	bzip	6634628	8604907	7724797	880110	62865	62865	8604907	2146676	2072136	70437	2142573	2258160	spneumo_pangenome_k32.r_1.0.S_greedytigs.k_15.d_na.M_default.C_bzip
spneumo_pangenome_k32	1.0	greedytigs	15	na	default	xz	6634628	8604907	7724797	880110	62865	62865	8604907	2146676	2072136	137624	2209760	2258160	spneumo_pangenome_k32.r_1.0.S_greedytigs.k_15.d_na.M_default.C_xz
spneumo_pangenome_k32	1.0	greedytigs	15	na	ones	bzip	6634628	8604907	7790823	814084	76106	62865	8604907	2146676	2072136	104186	2176322	2274368	spneumo_pangenome_k32.r_1.0.S_greedytigs.k_15.d_na.M_ones.C_bzip
spneumo_pangenome_k32	1.0	greedytigs	15	na	ones	xz	6634628	8604907	7790823	814084	76106	62865	8604907	2146676	2072136	172932	2245068	2274368	spneumo_pangenome_k32.r_1.0.S_greedytigs.k_15.d_na.M_ones.C_xz
spneumo_pangenome_k32	1.0	greedytigs	15	na	runsapprox	bzip	6634628	8604907	7790823	814084	76106	62865	8604907	2146676	2072136	104186	2176322	2274368	spneumo_pangenome_k32.r_1.0.S_greedytigs.k_15.d_na.M_runsapprox.C_bzip
spneumo_pangenome_k32	1.0	greedytigs	15	na	runsapprox	xz	6634628	8604907	7790823	814084	76106	62865	8604907	2146676	2072136	172932	2245068	2274368	spneumo_pangenome_k32.r_1.0.S_greedytigs.k_15.d_na.M_runsapprox.C_xz
spneumo_pangenome_k32	0.000000001	matchtigs	15	na	default	bzip	1	15	1	14	1	1	15	80	80	41	121	80	spneumo_pangenome_k32.r_0.000000001.S_matchtigs.k_15.d_na.M_default.C_bzip
spneumo_pangenome_k32	0.000000001	matchtigs	15	na	default	xz	1	15	1	14	1	1	15	80	80	76	156	80	spneumo_pangenome_k32.r_0.000000001.S_matchtigs.k_15.d_na.M_default.C_xz
spneumo_pangenome_k32	0.000000001	matchtigs	15	na	ones	bzip	1	15	1	14	1	1	15	80	80	41	121	80	spneumo_pangenome_k32.r_0.000000001.S_matchtigs.k_15.d_na.M_ones.C_bzip
spneumo_pangenome_k32	0.000000001	matchtigs	15	na	ones	xz	1	15	1	14	1	1	15	80	80	76	156	80	spneumo_pangenome_k32.r_0.000000001.S_matchtigs.k_15.d_na.M_ones.C_xz
spneumo_pangenome_k32	0.000000001	matchtigs	15	na	runsapprox	bzip	1	15	1	14	1	1	15	80	80	41	121	80	spneumo_pangenome_k32.r_0.000000001.S_matchtigs.k_15.d_na.M_runsapprox.C_bzip
spneumo_pangenome_k32	0.000000001	matchtigs	15	na	runsapprox	xz	1	15	1	14	1	1	15	80	80	76	156	80	spneumo_pangenome_k32.r_0.000000001.S_matchtigs.k_15.d_na.M_runsapprox.C_xz
spneumo_pangenome_k32	0.0001	matchtigs	15	na	default	bzip	663	9945	663	9282	663	663	9945	3116	2924	47	2971	3104	spneumo_pangenome_k32.r_0.0001.S_matchtigs.k_15.d_na.M_default.C_bzip
spneumo_pangenome_k32	0.0001	matchtigs	15	na	default	xz	663	9945	663	9282	663	663	9945	3116	2924	120	3044	3104	spneumo_pangenome_k32.r_0.0001.S_matchtigs.k_15.d_na.M_default.C_xz
spneumo_pangenome_k32	0.0001	matchtigs	15	na	ones	bzip	663	9945	663	9282	663	663	9945	3116	2924	47	2971	3104	spneumo_pangenome_k32.r_0.0001.S_matchtigs.k_15.d_na.M_ones.C_bzip
spneumo_pangenome_k32	0.0001	matchtigs	15	na	ones	xz	663	9945	663	9282	663	663	9945	3116	2924	120	3044	3104	spneumo_pangenome_k32.r_0.0001.S_matchtigs.k_15.d_na.M_ones.C_xz
spneumo_pangenome_k32	0.0001	matchtigs	15	na	runsapprox	bzip	663	9945	663	9282	663	663	9945	3116	2924	47	2971	3104	spneumo_pangenome_k32.r_0.0001.S_matchtigs.k_15.d_na.M_runsapprox.C_bzip
spneumo_pangenome_k32	0.0001	matchtigs	15	na	runsapprox	xz	663	9945	663	9282	663	663	9945	3116	2924	120	3044	3104	spneumo_pangenome_k32.r_0.0001.S_matchtigs.k_15.d_na.M_runsapprox.C_xz
spneumo_pangenome_k32	0.001	matchtigs	15	na	default	bzip	6634	99454	6634	92820	6630	6630	99454	26952	26000	56	26056	28624	spneumo_pangenome_k32.r_0.001.S_matchtigs.k_15.d_na.M_default.C_bzip
spneumo_pangenome_k32	0.001	matchtigs	15	na	default	xz	6634	99454	6634	92820	6630	6630	99454	26952	26000	180	26180	28624	spneumo_pangenome_k32.r_0.001.S_matchtigs.k_15.d_na.M_default.C_xz
spneumo_pangenome_k32	0.001	matchtigs	15	na	ones	bzip	6634	99454	6639	92815	6635	6630	99454	26952	26000	74	26074	28572	spneumo_pangenome_k32.r_0.001.S_matchtigs.k_15.d_na.M_ones.C_bzip
spneumo_pangenome_k32	0.001	matchtigs	15	na	ones	xz	6634	99454	6639	92815	6635	6630	99454	26952	26000	208	26208	28572	spneumo_pangenome_k32.r_0.001.S_matchtigs.k_15.d_na.M_ones.C_xz
spneumo_pangenome_k32	0.001	matchtigs	15	na	runsapprox	bzip	6634	99454	6639	92815	6635	6630	99454	26952	26000	74	26074	28572	spneumo_pangenome_k32.r_0.001.S_matchtigs.k_15.d_na.M_runsapprox.C_bzip
spneumo_pangenome_k32	0.001	matchtigs	15	na	runsapprox	xz	6634	99454	6639	92815	6635	6630	99454	26952	26000	208	26208	28572	spneumo_pangenome_k32.r_0.001.S_matchtigs.k_15.d_na.M_runsapprox.C_xz
spneumo_pangenome_k32	0.01	matchtigs	15	na	default	bzip	66346	985054	66346	918708	65622	65622	985054	273236	255056	1284	256340	281580	spneumo_pangenome_k32.r_0.01.S_matchtigs.k_15.d_na.M_default.C_bzip
spneumo_pangenome_k32	0.01	matchtigs	15	na	default	xz	66346	985054	66346	918708	65622	65622	985054	273236	255056	2276	257332	281580	spneumo_pangenome_k32.r_0.01.S_matchtigs.k_15.d_na.M_default.C_xz
spneumo_pangenome_k32	0.01	matchtigs	15	na	ones	bzip	66346	985054	66825	918229	66093	65622	985054	273236	255056	2304	257360	282100	spneumo_pangenome_k32.r_0.01.S_matchtigs.k_15.d_na.M_ones.C_bzip
spneumo_pangenome_k32	0.01	matchtigs	15	na	ones	xz	66346	985054	66825	918229	66093	65622	985054	273236	255056	4256	259312	282100	spneumo_pangenome_k32.r_0.01.S_matchtigs.k_15.d_na.M_ones.C_xz
spneumo_pangenome_k32	0.01	matchtigs	15	na	runsapprox	bzip	66346	985054	66825	918229	66093	65622	985054	273236	255056	2304	257360	282100	spneumo_pangenome_k32.r_0.01.S_matchtigs.k_15.d_na.M_runsapprox.C_bzip
spneumo_pangenome_k32	0.01	matchtigs	15	na	runsapprox	xz	66346	985054	66825	918229	66093	65622	985054	273236	255056	4256	259312	282100	spneumo_pangenome_k32.r_0.01.S_matchtigs.k_15.d_na.M_runsapprox.C_xz
spneumo_pangenome_k32	0.05	matchtigs	15	na	default	bzip	331731	4717875	331731	4386144	313296	313296	4717875	1336556	1202964	21245	1224209	1364236	spneumo_pangenome_k32.r_0.05.S_matchtigs.k_15.d_na.M_default.C_bzip
spneumo_pangenome_k32	0.05	matchtigs	15	na	default	xz	331731	4717875	331731	4386144	313296	313296	4717875	1336556	1202964	33612	1236576	1364236	spneumo_pangenome_k32.r_0.05.S_matchtigs.k_15.d_na.M_default.C_xz
spneumo_pangenome_k32	0.05	matchtigs	15	na	ones	bzip	331731	4717875	342628	4375247	323946	313296	4717875	1336556	1202964	39087	1242051	1376404	spneumo_pangenome_k32.r_0.05.S_matchtigs.k_15.d_na.M_ones.C_bzip
spneumo_pangenome_k32	0.05	matchtigs	15	na	ones	xz	331731	4717875	342628	4375247	323946	313296	4717875	1336556	1202964	63964	1266928	1376404	spneumo_pangenome_k32.r_0.05.S_matchtigs.k_15.d_na.M_ones.C_xz
spneumo_pangenome_k32	0.05	matchtigs	15	na	runsapprox	bzip	331731	4717875	342628	4375247	323946	313296	4717875	1336556	1202964	39087	1242051	1376404	spneumo_pangenome_k32.r_0.05.S_matchtigs.k_15.d_na.M_runsapprox.C_bzip
spneumo_pangenome_k32	0.05	matchtigs	15	na	runsapprox	xz	331731	4717875	342628	4375247	323946	313296	4717875	1336556	1202964	63964	1266928	1376404	spneumo_pangenome_k32.r_0.05.S_matchtigs.k_15.d_na.M_runsapprox.C_xz
spneumo_pangenome_k32	0.1	matchtigs	15	na	default	bzip	663462	8925758	663462	8262296	590164	590164	8925758	2563380	2276568	63006	2339574	2637160	spneumo_pangenome_k32.r_0.1.S_matchtigs.k_15.d_na.M_default.C_bzip
spneumo_pangenome_k32	0.1	matchtigs	15	na	default	xz	663462	8925758	663462	8262296	590164	590164	8925758	2563380	2276568	98176	2374744	2637160	spneumo_pangenome_k32.r_0.1.S_matchtigs.k_15.d_na.M_default.C_xz
spneumo_pangenome_k32	0.1	matchtigs	15	na	ones	bzip	663462	8925758	704049	8221709	628985	590164	8925758	2563380	2276568	123458	2400026	2675228	spneumo_pangenome_k32.r_0.1.S_matchtigs.k_15.d_na.M_ones.C_bzip
spneumo_pangenome_k32	0.1	matchtigs	15	na	ones	xz	663462	8925758	704049	8221709	628985	590164	8925758	2563380	2276568	189932	2466500	2675228	spneumo_pangenome_k32.r_0.1.S_matchtigs.k_15.d_na.M_ones.C_xz
spneumo_pangenome_k32	0.1	matchtigs	15	na	runsapprox	bzip	663462	8925758	704049	8221709	628985	590164	8925758	2563380	2276568	123458	2400026	2675228	spneumo_pangenome_k32.r_0.1.S_matchtigs.k_15.d_na.M_runsapprox.C_bzip
spneumo_pangenome_k32	0.1	matchtigs	15	na	runsapprox	xz	663462	8925758	704049	8221709	628985	590164	8925758	2563380	2276568	189932	2466500	2675228	spneumo_pangenome_k32.r_0.1.S_matchtigs.k_15.d_na.M_runsapprox.C_xz
spneumo_pangenome_k32	1.0	matchtigs	15	na	default	bzip	6634628	8328451	7315341	1013110	72365	72365	8328451	2118524	2034896	78358	2113254	2241588	spneumo_pangenome_k32.r_1.0.S_matchtigs.k_15.d_na.M_default.C_bzip
spneumo_pangenome_k32	1.0	matchtigs	15	na	default	xz	6634628	8328451	7315341	1013110	72365	72365	8328451	2118524	2034896	146916	2181812	2241588	spneumo_pangenome_k32.r_1.0.S_matchtigs.k_15.d_na.M_default.C_xz
spneumo_pangenome_k32	1.0	matchtigs	15	na	ones	bzip	6634628	8328451	7392370	936081	88469	72365	8328451	2118524	2034896	118257	2153153	2263236	spneumo_pangenome_k32.r_1.0.S_matchtigs.k_15.d_na.M_ones.C_bzip
spneumo_pangenome_k32	1.0	matchtigs	15	na	ones	xz	6634628	8328451	7392370	936081	88469	72365	8328451	2118524	2034896	188604	2223500	2263236	spneumo_pangenome_k32.r_1.0.S_matchtigs.k_15.d_na.M_ones.C_xz
spneumo_pangenome_k32	1.0	matchtigs	15	na	runsapprox	bzip	6634628	8328451	7392370	936081	88469	72365	8328451	2118524	2034896	118257	2153153	2263236	spneumo_pangenome_k32.r_1.0.S_matchtigs.k_15.d_na.M_runsapprox.C_bzip
spneumo_pangenome_k32	1.0	matchtigs	15	na	runsapprox	xz	6634628	8328451	7392370	936081	88469	72365	8328451	2118524	2034896	188604	2223500	2263236	spneumo_pangenome_k32.r_1.0.S_matchtigs.k_15.d_na.M_runsapprox.C_xz
spneumo_pangenome_k32	0.000000001	prophasm	15	na	default	bzip	1	15	1	14	1	1	15	80	80	41	121	80	spneumo_pangenome_k32.r_0.000000001.S_prophasm.k_15.d_na.M_default.C_bzip
spneumo_pangenome_k32	0.000000001	prophasm	15	na	default	xz	1	15	1	14	1	1	15	80	80	76	156	80	spneumo_pangenome_k32.r_0.000000001.S_prophasm.k_15.d_na.M_default.C_xz
spneumo_pangenome_k32	0.000000001	prophasm	15	na	ones	bzip	1	15	1	14	1	1	15	80	80	41	121	80	spneumo_pangenome_k32.r_0.000000001.S_prophasm.k_15.d_na.M_ones.C_bzip
spneumo_pangenome_k32	0.000000001	prophasm	15	na	ones	xz	1	15	1	14	1	1	15	80	80	76	156	80	spneumo_pangenome_k32.r_0.000000001.S_prophasm.k_15.d_na.M_ones.C_xz
spneumo_pangenome_k32	0.000000001	prophasm	15	na	runsapprox	bzip	1	15	1	14	1	1	15	80	80	41	121	80	spneumo_pangenome_k32.r_0.000000001.S_prophasm.k_15.d_na.M_runsapprox.C_bzip
spneumo_pangenome_k32	0.000000001	prophasm	15	na	runsapprox	xz	1	15	1	14	1	1	15	80	80	76	156	80	spneumo_pangenome_k32.r_0.000000001.S_prophasm.k_15.d_na.M_runsapprox.C_xz
spneumo_pangenome_k32	0.0001	prophasm	15	na	default	bzip	663	9945	663	9282	663	663	9945	3360	3032	47	3079	3572	spneumo_pangenome_k32.r_0.0001.S_prophasm.k_15.d_na.M_default.C_bzip
spneumo_pangenome_k32	0.0001	prophasm	15	na	default	xz	663	9945	663	9282	663	663	9945	3360	3032	120	3152	3572	spneumo_pangenome_k32.r_0.0001.S_prophasm.k_15.d_na.M_default.C_xz
spneumo_pangenome_k32	0.0001	prophasm	15	na	ones	bzip	663	9945	663	9282	663	663	9945	3360	3032	47	3079	3572	spneumo_pangenome_k32.r_0.0001.S_prophasm.k_15.d_na.M_ones.C_bzip
spneumo_pangenome_k32	0.0001	prophasm	15	na	ones	xz	663	9945	663	9282	663	663	9945	3360	3032	120	3152	3572	spneumo_pangenome_k32.r_0.0001.S_prophasm.k_15.d_na.M_ones.C_xz
spneumo_pangenome_k32	0.0001	prophasm	15	na	runsapprox	bzip	663	9945	663	9282	663	663	9945	3360	3032	47	3079	3572	spneumo_pangenome_k32.r_0.0001.S_prophasm.k_15.d_na.M_runsapprox.C_bzip
spneumo_pangenome_k32	0.0001	prophasm	15	na	runsapprox	xz	663	9945	663	9282	663	663	9945	3360	3032	120	3152	3572	spneumo_pangenome_k32.r_0.0001.S_prophasm.k_15.d_na.M_runsapprox.C_xz
spneumo_pangenome_k32	0.001	prophasm	15	na	default	bzip	6634	99454	6634	92820	6630	6630	99454	29656	27272	55	27327	31856	spneumo_pangenome_k32.r_0.001.S_prophasm.k_15.d_na.M_default.C_bzip
spneumo_pangenome_k32	0.001	prophasm	15	na	default	xz	6634	99454	6634	92820	6630	6630	99454	29656	27272	180	27452	31856	spneumo_pangenome_k32.r_0.001.S_prophasm.k_15.d_na.M_default.C_xz
spneumo_pangenome_k32	0.001	prophasm	15	na	ones	bzip	6634	99454	6637	92817	6633	6630	99454	29656	27272	69	27341	31816	spneumo_pangenome_k32.r_0.001.S_prophasm.k_15.d_na.M_ones.C_bzip
spneumo_pangenome_k32	0.001	prophasm	15	na	ones	xz	6634	99454	6637	92817	6633	6630	99454	29656	27272	196	27468	31816	spneumo_pangenome_k32.r_0.001.S_prophasm.k_15.d_na.M_ones.C_xz
spneumo_pangenome_k32	0.001	prophasm	15	na	runsapprox	bzip	6634	99454	6637	92817	6633	6630	99454	29656	27272	69	27341	31816	spneumo_pangenome_k32.r_0.001.S_prophasm.k_15.d_na.M_runsapprox.C_bzip
spneumo_pangenome_k32	0.001	prophasm	15	na	runsapprox	xz	6634	99454	6637	92817	6633	6630	99454	29656	27272	196	27468	31816	spneumo_pangenome_k32.r_0.001.S_prophasm.k_15.d_na.M_runsapprox.C_xz
spneumo_pangenome_k32	0.01	prophasm	15	na	default	bzip	66346	985054	66346	918708	65622	65622	985054	297264	260308	1273	261581	301332	spneumo_pangenome_k32.r_0.01.S_prophasm.k_15.d_na.M_default.C_bzip
spneumo_pangenome_k32	0.01	prophasm	15	na	default	xz	66346	985054	66346	918708	65622	65622	985054	297264	260308	2172	262480	301332	spneumo_pangenome_k32.r_0.01.S_prophasm.k_15.d_na.M_default.C_xz
spneumo_pangenome_k32	0.01	prophasm	15	na	ones	bzip	66346	985054	66781	918273	66053	65622	985054	297264	260308	2222	262530	301484	spneumo_pangenome_k32.r_0.01.S_prophasm.k_15.d_na.M_ones.C_bzip
spneumo_pangenome_k32	0.01	prophasm	15	na	ones	xz	66346	985054	66781	918273	66053	65622	985054	297264	260308	3996	264304	301484	spneumo_pangenome_k32.r_0.01.S_prophasm.k_15.d_na.M_ones.C_xz
spneumo_pangenome_k32	0.01	prophasm	15	na	runsapprox	bzip	66346	985054	66781	918273	66053	65622	985054	297264	260308	2222	262530	301484	spneumo_pangenome_k32.r_0.01.S_prophasm.k_15.d_na.M_runsapprox.C_bzip
spneumo_pangenome_k32	0.01	prophasm	15	na	runsapprox	xz	66346	985054	66781	918273	66053	65622	985054	297264	260308	3996	264304	301484	spneumo_pangenome_k32.r_0.01.S_prophasm.k_15.d_na.M_runsapprox.C_xz
spneumo_pangenome_k32	0.05	prophasm	15	na	default	bzip	331731	4717875	331731	4386144	313296	313296	4717875	1406876	1228676	20023	1248699	1432080	spneumo_pangenome_k32.r_0.05.S_prophasm.k_15.d_na.M_default.C_bzip
spneumo_pangenome_k32	0.05	prophasm	15	na	default	xz	331731	4717875	331731	4386144	313296	313296	4717875	1406876	1228676	31424	1260100	1432080	spneumo_pangenome_k32.r_0.05.S_prophasm.k_15.d_na.M_default.C_xz
spneumo_pangenome_k32	0.05	prophasm	15	na	ones	bzip	331731	4717875	342975	4374900	324301	313296	4717875	1406876	1228676	38649	1267325	1427024	spneumo_pangenome_k32.r_0.05.S_prophasm.k_15.d_na.M_ones.C_bzip
spneumo_pangenome_k32	0.05	prophasm	15	na	ones	xz	331731	4717875	342975	4374900	324301	313296	4717875	1406876	1228676	63612	1292288	1427024	spneumo_pangenome_k32.r_0.05.S_prophasm.k_15.d_na.M_ones.C_xz
spneumo_pangenome_k32	0.05	prophasm	15	na	runsapprox	bzip	331731	4717875	342975	4374900	324301	313296	4717875	1406876	1228676	38649	1267325	1427024	spneumo_pangenome_k32.r_0.05.S_prophasm.k_15.d_na.M_runsapprox.C_bzip
spneumo_pangenome_k32	0.05	prophasm	15	na	runsapprox	xz	331731	4717875	342975	4374900	324301	313296	4717875	1406876	1228676	63612	1292288	1427024	spneumo_pangenome_k32.r_0.05.S_prophasm.k_15.d_na.M_runsapprox.C_xz
spneumo_pangenome_k32	0.1	prophasm	15	na	default	bzip	663462	8925758	663462	8262296	590164	590164	8925758	2651152	2313796	59118	2372914	2645360	spneumo_pangenome_k32.r_0.1.S_prophasm.k_15.d_na.M_default.C_bzip
spneumo_pangenome_k32	0.1	prophasm	15	na	default	xz	663462	8925758	663462	8262296	590164	590164	8925758	2651152	2313796	92000	2405796	2645360	spneumo_pangenome_k32.r_0.1.S_prophasm.k_15.d_na.M_default.C_xz
spneumo_pangenome_k32	0.1	prophasm	15	na	ones	bzip	663462	8925758	705662	8220096	630525	590164	8925758	2651152	2313796	121534	2435330	2727236	spneumo_pangenome_k32.r_0.1.S_prophasm.k_15.d_na.M_ones.C_bzip
spneumo_pangenome_k32	0.1	prophasm	15	na	ones	xz	663462	8925758	705662	8220096	630525	590164	8925758	2651152	2313796	189040	2502836	2727236	spneumo_pangenome_k32.r_0.1.S_prophasm.k_15.d_na.M_ones.C_xz
spneumo_pangenome_k32	0.1	prophasm	15	na	runsapprox	bzip	663462	8925758	705662	8220096	630525	590164	8925758	2651152	2313796	121534	2435330	2727236	spneumo_pangenome_k32.r_0.1.S_prophasm.k_15.d_na.M_runsapprox.C_bzip
spneumo_pangenome_k32	0.1	prophasm	15	na	runsapprox	xz	663462	8925758	705662	8220096	630525	590164	8925758	2651152	2313796	189040	2502836	2727236	spneumo_pangenome_k32.r_0.1.S_prophasm.k_15.d_na.M_runsapprox.C_xz
spneumo_pangenome_k32	0.2	prophasm	15	na	default	bzip	1326925	15887023	1326925	14560098	1040007	1040007	15887023	4705924	4105684	162757	4268441	4791428	spneumo_pangenome_k32.r_0.2.S_prophasm.k_15.d_na.M_default.C_bzip
spneumo_pangenome_k32	0.2	prophasm	15	na	default	xz	1326925	15887023	1326925	14560098	1040007	1040007	15887023	4705924	4105684	250568	4356252	4791428	spneumo_pangenome_k32.r_0.2.S_prophasm.k_15.d_na.M_default.C_xz
spneumo_pangenome_k32	0.2	prophasm	15	na	ones	bzip	1326925	15887023	1475103	14411920	1174996	1040007	15887023	4705924	4105684	358306	4463990	4949848	spneumo_pangenome_k32.r_0.2.S_prophasm.k_15.d_na.M_ones.C_bzip
spneumo_pangenome_k32	0.2	prophasm	15	na	ones	xz	1326925	15887023	1475103	14411920	1174996	1040007	15887023	4705924	4105684	501096	4606780	4949848	spneumo_pangenome_k32.r_0.2.S_prophasm.k_15.d_na.M_ones.C_xz
spneumo_pangenome_k32	0.2	prophasm	15	na	runsapprox	bzip	1326925	15887023	1475103	14411920	1174996	1040007	15887023	4705924	4105684	358306	4463990	4949848	spneumo_pangenome_k32.r_0.2.S_prophasm.k_15.d_na.M_runsapprox.C_bzip
spneumo_pangenome_k32	0.2	prophasm	15	na	runsapprox	xz	1326925	15887023	1475103	14411920	1174996	1040007	15887023	4705924	4105684	501096	4606780	4949848	spneumo_pangenome_k32.r_0.2.S_prophasm.k_15.d_na.M_runsapprox.C_xz
spneumo_pangenome_k32	0.3	prophasm	15	na	default	bzip	1990388	20989984	1990388	18999596	1357114	1357114	20989984	6213056	5414224	281303	5695527	6333608	spneumo_pangenome_k32.r_0.3.S_prophasm.k_15.d_na.M_default.C_bzip
spneumo_pangenome_k32	0.3	prophasm	15	na	default	xz	1990388	20989984	1990388	18999596	1357114	1357114	20989984	6213056	5414224	419864	5834088	6333608	spneumo_pangenome_k32.r_0.3.S_prophasm.k_15.d_na.M_default.C_xz
spneumo_pangenome_k32	0.3	prophasm	15	na	ones	bzip	1990388	20989984	2281485	18708499	1609639	1357114	20989984	6213056	5414224	635242	6049466	6585880	spneumo_pangenome_k32.r_0.3.S_prophasm.k_15.d_na.M_ones.C_bzip
spneumo_pangenome_k32	0.3	prophasm	15	na	ones	xz	1990388	20989984	2281485	18708499	1609639	1357114	20989984	6213056	5414224	819532	6233756	6585880	spneumo_pangenome_k32.r_0.3.S_prophasm.k_15.d_na.M_ones.C_xz
spneumo_pangenome_k32	0.3	prophasm	15	na	runsapprox	bzip	1990388	20989984	2281485	18708499	1609639	1357114	20989984	6213056	5414224	635242	6049466	6585880	spneumo_pangenome_k32.r_0.3.S_prophasm.k_15.d_na.M_runsapprox.C_bzip
spneumo_pangenome_k32	0.3	prophasm	15	na	runsapprox	xz	1990388	20989984	2281485	18708499	1609639	1357114	20989984	6213056	5414224	819532	6233756	6585880	spneumo_pangenome_k32.r_0.3.S_prophasm.k_15.d_na.M_runsapprox.C_xz
spneumo_pangenome_k32	0.4	prophasm	15	na	default	bzip	2653851	24339571	2653851	21685720	1548980	1548980	24339571	7203164	6272484	397787	6670271	7405372	spneumo_pangenome_k32.r_0.4.S_prophasm.k_15.d_na.M_default.C_bzip
spneumo_pangenome_k32	0.4	prophasm	15	na	default	xz	2653851	24339571	2653851	21685720	1548980	1548980	24339571	7203164	6272484	573144	6845628	7405372	spneumo_pangenome_k32.r_0.4.S_prophasm.k_15.d_na.M_default.C_xz
spneumo_pangenome_k32	0.4	prophasm	15	na	ones	bzip	2653851	24339571	3100887	21238684	1915654	1548980	24339571	7203164	6272484	906550	7179034	7778384	spneumo_pangenome_k32.r_0.4.S_prophasm.k_15.d_na.M_ones.C_bzip
spneumo_pangenome_k32	0.4	prophasm	15	na	ones	xz	2653851	24339571	3100887	21238684	1915654	1548980	24339571	7203164	6272484	1100208	7372692	7778384	spneumo_pangenome_k32.r_0.4.S_prophasm.k_15.d_na.M_ones.C_xz
spneumo_pangenome_k32	0.4	prophasm	15	na	runsapprox	bzip	2653851	24339571	3100887	21238684	1915654	1548980	24339571	7203164	6272484	906550	7179034	7778384	spneumo_pangenome_k32.r_0.4.S_prophasm.k_15.d_na.M_runsapprox.C_bzip
spneumo_pangenome_k32	0.4	prophasm	15	na	runsapprox	xz	2653851	24339571	3100887	21238684	1915654	1548980	24339571	7203164	6272484	1100208	7372692	7778384	spneumo_pangenome_k32.r_0.4.S_prophasm.k_15.d_na.M_runsapprox.C_xz
spneumo_pangenome_k32	0.5	prophasm	15	na	default	bzip	3317314	26004160	3317314	22686846	1620489	1620489	26004160	7689988	6693872	497120	7190992	7976536	spneumo_pangenome_k32.r_0.5.S_prophasm.k_15.d_na.M_default.C_bzip
spneumo_pangenome_k32	0.5	prophasm	15	na	default	xz	3317314	26004160	3317314	22686846	1620489	1620489	26004160	7689988	6693872	692160	7386032	7976536	spneumo_pangenome_k32.r_0.5.S_prophasm.k_15.d_na.M_default.C_xz
spneumo_pangenome_k32	0.5	prophasm	15	na	ones	bzip	3317314	26004160	3907067	22097093	2076670	1620489	26004160	7689988	6693872	1127661	7821533	8451496	spneumo_pangenome_k32.r_0.5.S_prophasm.k_15.d_na.M_ones.C_bzip
spneumo_pangenome_k32	0.5	prophasm	15	na	ones	xz	3317314	26004160	3907067	22097093	2076670	1620489	26004160	7689988	6693872	1315164	8009036	8451496	spneumo_pangenome_k32.r_0.5.S_prophasm.k_15.d_na.M_ones.C_xz
spneumo_pangenome_k32	0.5	prophasm	15	na	runsapprox	bzip	3317314	26004160	3907067	22097093	2076670	1620489	26004160	7689988	6693872	1127661	7821533	8451496	spneumo_pangenome_k32.r_0.5.S_prophasm.k_15.d_na.M_runsapprox.C_bzip
spneumo_pangenome_k32	0.5	prophasm	15	na	runsapprox	xz	3317314	26004160	3907067	22097093	2076670	1620489	26004160	7689988	6693872	1315164	8009036	8451496	spneumo_pangenome_k32.r_0.5.S_prophasm.k_15.d_na.M_runsapprox.C_xz
spneumo_pangenome_k32	0.6	prophasm	15	na	default	bzip	3980776	26020752	3980776	22039976	1574284	1574284	26020752	7686420	6695916	562854	7258770	8254832	spneumo_pangenome_k32.r_0.6.S_prophasm.k_15.d_na.M_default.C_bzip
spneumo_pangenome_k32	0.6	prophasm	15	na	default	xz	3980776	26020752	3980776	22039976	1574284	1574284	26020752	7686420	6695916	761844	7457760	8254832	spneumo_pangenome_k32.r_0.6.S_prophasm.k_15.d_na.M_default.C_xz
spneumo_pangenome_k32	0.6	prophasm	15	na	ones	bzip	3980776	26020752	4683846	21336906	2081995	1574284	26020752	7686420	6695916	1271305	7967221	8685424	spneumo_pangenome_k32.r_0.6.S_prophasm.k_15.d_na.M_ones.C_bzip
spneumo_pangenome_k32	0.6	prophasm	15	na	ones	xz	3980776	26020752	4683846	21336906	2081995	1574284	26020752	7686420	6695916	1440812	8136728	8685424	spneumo_pangenome_k32.r_0.6.S_prophasm.k_15.d_na.M_ones.C_xz
spneumo_pangenome_k32	0.6	prophasm	15	na	runsapprox	bzip	3980776	26020752	4683846	21336906	2081995	1574284	26020752	7686420	6695916	1271305	7967221	8685424	spneumo_pangenome_k32.r_0.6.S_prophasm.k_15.d_na.M_runsapprox.C_bzip
spneumo_pangenome_k32	0.6	prophasm	15	na	runsapprox	xz	3980776	26020752	4683846	21336906	2081995	1574284	26020752	7686420	6695916	1440812	8136728	8685424	spneumo_pangenome_k32.r_0.6.S_prophasm.k_15.d_na.M_runsapprox.C_xz
spneumo_pangenome_k32	0.7	prophasm	15	na	default	bzip	4644239	24445111	4644239	19800872	1414348	1414348	24445111	7208644	6285788	580869	6866657	7797264	spneumo_pangenome_k32.r_0.7.S_prophasm.k_15.d_na.M_default.C_bzip
spneumo_pangenome_k32	0.7	prophasm	15	na	default	xz	4644239	24445111	4644239	19800872	1414348	1414348	24445111	7208644	6285788	770344	7056132	7797264	spneumo_pangenome_k32.r_0.7.S_prophasm.k_15.d_na.M_default.C_xz
spneumo_pangenome_k32	0.7	prophasm	15	na	ones	bzip	4644239	24445111	5406518	19038593	1919919	1414348	24445111	7208644	6285788	1298478	7584266	8237996	spneumo_pangenome_k32.r_0.7.S_prophasm.k_15.d_na.M_ones.C_bzip
spneumo_pangenome_k32	0.7	prophasm	15	na	ones	xz	4644239	24445111	5406518	19038593	1919919	1414348	24445111	7208644	6285788	1452928	7738716	8237996	spneumo_pangenome_k32.r_0.7.S_prophasm.k_15.d_na.M_ones.C_xz
spneumo_pangenome_k32	0.7	prophasm	15	na	runsapprox	bzip	4644239	24445111	5406518	19038593	1919919	1414348	24445111	7208644	6285788	1298478	7584266	8237996	spneumo_pangenome_k32.r_0.7.S_prophasm.k_15.d_na.M_runsapprox.C_bzip
spneumo_pangenome_k32	0.7	prophasm	15	na	runsapprox	xz	4644239	24445111	5406518	19038593	1919919	1414348	24445111	7208644	6285788	1452928	7738716	8237996	spneumo_pangenome_k32.r_0.7.S_prophasm.k_15.d_na.M_runsapprox.C_xz
spneumo_pangenome_k32	0.8	prophasm	15	na	default	bzip	5307702	21271902	5307702	15964200	1140300	1140300	21271902	6245820	5466904	536550	6003454	6796524	spneumo_pangenome_k32.r_0.8.S_prophasm.k_15.d_na.M_default.C_bzip
spneumo_pangenome_k32	0.8	prophasm	15	na	default	xz	5307702	21271902	5307702	15964200	1140300	1140300	21271902	6245820	5466904	710224	6177128	6796524	spneumo_pangenome_k32.r_0.8.S_prophasm.k_15.d_na.M_default.C_xz
spneumo_pangenome_k32	0.8	prophasm	15	na	ones	bzip	5307702	21271902	6051075	15220827	1580009	1140300	21271902	6245820	5466904	1184341	6651245	7195412	spneumo_pangenome_k32.r_0.8.S_prophasm.k_15.d_na.M_ones.C_bzip
spneumo_pangenome_k32	0.8	prophasm	15	na	ones	xz	5307702	21271902	6051075	15220827	1580009	1140300	21271902	6245820	5466904	1325292	6792196	7195412	spneumo_pangenome_k32.r_0.8.S_prophasm.k_15.d_na.M_ones.C_xz
spneumo_pangenome_k32	0.8	prophasm	15	na	runsapprox	bzip	5307702	21271902	6051075	15220827	1580009	1140300	21271902	6245820	5466904	1184341	6651245	7195412	spneumo_pangenome_k32.r_0.8.S_prophasm.k_15.d_na.M_runsapprox.C_bzip
spneumo_pangenome_k32	0.8	prophasm	15	na	runsapprox	xz	5307702	21271902	6051075	15220827	1580009	1140300	21271902	6245820	5466904	1325292	6792196	7195412	spneumo_pangenome_k32.r_0.8.S_prophasm.k_15.d_na.M_runsapprox.C_xz
spneumo_pangenome_k32	0.9	prophasm	15	na	default	bzip	5971165	16493985	5971165	10522820	751630	751630	16493985	4777968	4225036	415478	4640514	5233488	spneumo_pangenome_k32.r_0.9.S_prophasm.k_15.d_na.M_default.C_bzip
spneumo_pangenome_k32	0.9	prophasm	15	na	default	xz	5971165	16493985	5971165	10522820	751630	751630	16493985	4777968	4225036	564836	4789872	5233488	spneumo_pangenome_k32.r_0.9.S_prophasm.k_15.d_na.M_default.C_xz
spneumo_pangenome_k32	0.9	prophasm	15	na	ones	bzip	5971165	16493985	6594871	9899114	1054401	751630	16493985	4777968	4225036	896520	5121556	5530372	spneumo_pangenome_k32.r_0.9.S_prophasm.k_15.d_na.M_ones.C_bzip
spneumo_pangenome_k32	0.9	prophasm	15	na	ones	xz	5971165	16493985	6594871	9899114	1054401	751630	16493985	4777968	4225036	1024264	5249300	5530372	spneumo_pangenome_k32.r_0.9.S_prophasm.k_15.d_na.M_ones.C_xz
spneumo_pangenome_k32	0.9	prophasm	15	na	runsapprox	bzip	5971165	16493985	6594871	9899114	1054401	751630	16493985	4777968	4225036	896520	5121556	5530372	spneumo_pangenome_k32.r_0.9.S_prophasm.k_15.d_na.M_runsapprox.C_bzip
spneumo_pangenome_k32	0.9	prophasm	15	na	runsapprox	xz	5971165	16493985	6594871	9899114	1054401	751630	16493985	4777968	4225036	1024264	5249300	5530372	spneumo_pangenome_k32.r_0.9.S_prophasm.k_15.d_na.M_runsapprox.C_xz
spneumo_pangenome_k32	1.0	prophasm	15	na	default	bzip	6634628	10113096	6634628	3478468	248462	248462	10113096	2680044	2505576	186881	2692457	2965412	spneumo_pangenome_k32.r_1.0.S_prophasm.k_15.d_na.M_default.C_bzip
spneumo_pangenome_k32	1.0	prophasm	15	na	default	xz	6634628	10113096	6634628	3478468	248462	248462	10113096	2680044	2505576	279484	2785060	2965412	spneumo_pangenome_k32.r_1.0.S_prophasm.k_15.d_na.M_default.C_xz
spneumo_pangenome_k32	1.0	prophasm	15	na	ones	bzip	6634628	10113096	7020177	3092919	340635	248462	10113096	2680044	2505576	378028	2883604	3071876	spneumo_pangenome_k32.r_1.0.S_prophasm.k_15.d_na.M_ones.C_bzip
spneumo_pangenome_k32	1.0	prophasm	15	na	ones	xz	6634628	10113096	7020177	3092919	340635	248462	10113096	2680044	2505576	464488	2970064	3071876	spneumo_pangenome_k32.r_1.0.S_prophasm.k_15.d_na.M_ones.C_xz
spneumo_pangenome_k32	1.0	prophasm	15	na	runsapprox	bzip	6634628	10113096	7020177	3092919	340635	248462	10113096	2680044	2505576	378028	2883604	3071876	spneumo_pangenome_k32.r_1.0.S_prophasm.k_15.d_na.M_runsapprox.C_bzip
spneumo_pangenome_k32	1.0	prophasm	15	na	runsapprox	xz	6634628	10113096	7020177	3092919	340635	248462	10113096	2680044	2505576	464488	2970064	3071876	spneumo_pangenome_k32.r_1.0.S_prophasm.k_15.d_na.M_runsapprox.C_xz
spneumo_pangenome_k32	0.000000001	eulertigs	17	na	default	bzip	1	17	1	16	1	1	17	84	84	41	125	84	spneumo_pangenome_k32.r_0.000000001.S_eulertigs.k_17.d_na.M_default.C_bzip
spneumo_pangenome_k32	0.000000001	eulertigs	17	na	default	xz	1	17	1	16	1	1	17	84	84	76	160	84	spneumo_pangenome_k32.r_0.000000001.S_eulertigs.k_17.d_na.M_default.C_xz
spneumo_pangenome_k32	0.000000001	eulertigs	17	na	ones	bzip	1	17	1	16	1	1	17	84	84	41	125	84	spneumo_pangenome_k32.r_0.000000001.S_eulertigs.k_17.d_na.M_ones.C_bzip
spneumo_pangenome_k32	0.000000001	eulertigs	17	na	ones	xz	1	17	1	16	1	1	17	84	84	76	160	84	spneumo_pangenome_k32.r_0.000000001.S_eulertigs.k_17.d_na.M_ones.C_xz
spneumo_pangenome_k32	0.000000001	eulertigs	17	na	runsapprox	bzip	1	17	1	16	1	1	17	84	84	41	125	84	spneumo_pangenome_k32.r_0.000000001.S_eulertigs.k_17.d_na.M_runsapprox.C_bzip
spneumo_pangenome_k32	0.000000001	eulertigs	17	na	runsapprox	xz	1	17	1	16	1	1	17	84	84	76	160	84	spneumo_pangenome_k32.r_0.000000001.S_eulertigs.k_17.d_na.M_runsapprox.C_xz
spneumo_pangenome_k32	0.0001	eulertigs	17	na	default	bzip	717	12189	717	11472	717	717	12189	3808	3564	47	3611	3776	spneumo_pangenome_k32.r_0.0001.S_eulertigs.k_17.d_na.M_default.C_bzip
spneumo_pangenome_k32	0.0001	eulertigs	17	na	default	xz	717	12189	717	11472	717	717	12189	3808	3564	124	3688	3776	spneumo_pangenome_k32.r_0.0001.S_eulertigs.k_17.d_na.M_default.C_xz
spneumo_pangenome_k32	0.0001	eulertigs	17	na	ones	bzip	717	12189	717	11472	717	717	12189	3808	3564	47	3611	3776	spneumo_pangenome_k32.r_0.0001.S_eulertigs.k_17.d_na.M_ones.C_bzip
spneumo_pangenome_k32	0.0001	eulertigs	17	na	ones	xz	717	12189	717	11472	717	717	12189	3808	3564	124	3688	3776	spneumo_pangenome_k32.r_0.0001.S_eulertigs.k_17.d_na.M_ones.C_xz
spneumo_pangenome_k32	0.0001	eulertigs	17	na	runsapprox	bzip	717	12189	717	11472	717	717	12189	3808	3564	47	3611	3776	spneumo_pangenome_k32.r_0.0001.S_eulertigs.k_17.d_na.M_runsapprox.C_bzip
spneumo_pangenome_k32	0.0001	eulertigs	17	na	runsapprox	xz	717	12189	717	11472	717	717	12189	3808	3564	124	3688	3776	spneumo_pangenome_k32.r_0.0001.S_eulertigs.k_17.d_na.M_runsapprox.C_xz
spneumo_pangenome_k32	0.001	eulertigs	17	na	default	bzip	7170	121762	7170	114592	7162	7162	121762	33816	31696	65	31761	33880	spneumo_pangenome_k32.r_0.001.S_eulertigs.k_17.d_na.M_default.C_bzip
spneumo_pangenome_k32	0.001	eulertigs	17	na	default	xz	7170	121762	7170	114592	7162	7162	121762	33816	31696	200	31896	33880	spneumo_pangenome_k32.r_0.001.S_eulertigs.k_17.d_na.M_default.C_xz
spneumo_pangenome_k32	0.001	eulertigs	17	na	ones	bzip	7170	121762	7171	114591	7163	7162	121762	33816	31696	70	31766	33880	spneumo_pangenome_k32.r_0.001.S_eulertigs.k_17.d_na.M_ones.C_bzip
spneumo_pangenome_k32	0.001	eulertigs	17	na	ones	xz	7170	121762	7171	114591	7163	7162	121762	33816	31696	208	31904	33880	spneumo_pangenome_k32.r_0.001.S_eulertigs.k_17.d_na.M_ones.C_xz
spneumo_pangenome_k32	0.001	eulertigs	17	na	runsapprox	bzip	7170	121762	7171	114591	7163	7162	121762	33816	31696	70	31766	33880	spneumo_pangenome_k32.r_0.001.S_eulertigs.k_17.d_na.M_runsapprox.C_bzip
spneumo_pangenome_k32	0.001	eulertigs	17	na	runsapprox	xz	7170	121762	7171	114591	7163	7162	121762	33816	31696	208	31904	33880	spneumo_pangenome_k32.r_0.001.S_eulertigs.k_17.d_na.M_runsapprox.C_xz
spneumo_pangenome_k32	0.01	eulertigs	17	na	default	bzip	71707	1207131	71707	1135424	70964	70964	1207131	342104	311140	1328	312468	347580	spneumo_pangenome_k32.r_0.01.S_eulertigs.k_17.d_na.M_default.C_bzip
spneumo_pangenome_k32	0.01	eulertigs	17	na	default	xz	71707	1207131	71707	1135424	70964	70964	1207131	342104	311140	2352	313492	347580	spneumo_pangenome_k32.r_0.01.S_eulertigs.k_17.d_na.M_default.C_xz
spneumo_pangenome_k32	0.01	eulertigs	17	na	ones	bzip	71707	1207131	71898	1135233	71155	70964	1207131	342104	311140	1746	312886	347540	spneumo_pangenome_k32.r_0.01.S_eulertigs.k_17.d_na.M_ones.C_bzip
spneumo_pangenome_k32	0.01	eulertigs	17	na	ones	xz	71707	1207131	71898	1135233	71155	70964	1207131	342104	311140	3280	314420	347540	spneumo_pangenome_k32.r_0.01.S_eulertigs.k_17.d_na.M_ones.C_xz
spneumo_pangenome_k32	0.01	eulertigs	17	na	runsapprox	bzip	71707	1207131	71898	1135233	71155	70964	1207131	342104	311140	1746	312886	347540	spneumo_pangenome_k32.r_0.01.S_eulertigs.k_17.d_na.M_runsapprox.C_bzip
spneumo_pangenome_k32	0.01	eulertigs	17	na	runsapprox	xz	71707	1207131	71898	1135233	71155	70964	1207131	342104	311140	3280	314420	347540	spneumo_pangenome_k32.r_0.01.S_eulertigs.k_17.d_na.M_runsapprox.C_xz
spneumo_pangenome_k32	0.05	eulertigs	17	na	default	bzip	358536	5800104	358536	5441568	340098	340098	5800104	1651216	1477244	21821	1499065	1684656	spneumo_pangenome_k32.r_0.05.S_eulertigs.k_17.d_na.M_default.C_bzip
spneumo_pangenome_k32	0.05	eulertigs	17	na	default	xz	358536	5800104	358536	5441568	340098	340098	5800104	1651216	1477244	34396	1511640	1684656	spneumo_pangenome_k32.r_0.05.S_eulertigs.k_17.d_na.M_default.C_xz
spneumo_pangenome_k32	0.05	eulertigs	17	na	ones	bzip	358536	5800104	362936	5437168	344400	340098	5800104	1651216	1477244	29343	1506587	1686560	spneumo_pangenome_k32.r_0.05.S_eulertigs.k_17.d_na.M_ones.C_bzip
spneumo_pangenome_k32	0.05	eulertigs	17	na	ones	xz	358536	5800104	362936	5437168	344400	340098	5800104	1651216	1477244	49168	1526412	1686560	spneumo_pangenome_k32.r_0.05.S_eulertigs.k_17.d_na.M_ones.C_xz
spneumo_pangenome_k32	0.05	eulertigs	17	na	runsapprox	bzip	358536	5800104	362936	5437168	344400	340098	5800104	1651216	1477244	29343	1506587	1686560	spneumo_pangenome_k32.r_0.05.S_eulertigs.k_17.d_na.M_runsapprox.C_bzip
spneumo_pangenome_k32	0.05	eulertigs	17	na	runsapprox	xz	358536	5800104	362936	5437168	344400	340098	5800104	1651216	1477244	49168	1526412	1686560	spneumo_pangenome_k32.r_0.05.S_eulertigs.k_17.d_na.M_runsapprox.C_xz
spneumo_pangenome_k32	0.1	eulertigs	17	na	default	bzip	717072	11008928	717072	10291856	643241	643241	11008928	3133452	2781568	65717	2847285	3222684	spneumo_pangenome_k32.r_0.1.S_eulertigs.k_17.d_na.M_default.C_bzip
spneumo_pangenome_k32	0.1	eulertigs	17	na	default	xz	717072	11008928	717072	10291856	643241	643241	11008928	3133452	2781568	103136	2884704	3222684	spneumo_pangenome_k32.r_0.1.S_eulertigs.k_17.d_na.M_default.C_xz
spneumo_pangenome_k32	0.1	eulertigs	17	na	ones	bzip	717072	11008928	733922	10275006	659530	643241	11008928	3133452	2781568	91861	2873429	3239440	spneumo_pangenome_k32.r_0.1.S_eulertigs.k_17.d_na.M_ones.C_bzip
spneumo_pangenome_k32	0.1	eulertigs	17	na	ones	xz	717072	11008928	733922	10275006	659530	643241	11008928	3133452	2781568	150948	2932516	3239440	spneumo_pangenome_k32.r_0.1.S_eulertigs.k_17.d_na.M_ones.C_xz
spneumo_pangenome_k32	0.1	eulertigs	17	na	runsapprox	bzip	717072	11008928	733922	10275006	659530	643241	11008928	3133452	2781568	91861	2873429	3239440	spneumo_pangenome_k32.r_0.1.S_eulertigs.k_17.d_na.M_runsapprox.C_bzip
spneumo_pangenome_k32	0.1	eulertigs	17	na	runsapprox	xz	717072	11008928	733922	10275006	659530	643241	11008928	3133452	2781568	150948	2932516	3239440	spneumo_pangenome_k32.r_0.1.S_eulertigs.k_17.d_na.M_runsapprox.C_xz
spneumo_pangenome_k32	0.2	eulertigs	17	na	default	bzip	1434145	19693121	1434145	18258976	1141186	1141186	19693121	5606052	4947288	183049	5130337	5824304	spneumo_pangenome_k32.r_0.2.S_eulertigs.k_17.d_na.M_default.C_bzip
spneumo_pangenome_k32	0.2	eulertigs	17	na	default	xz	1434145	19693121	1434145	18258976	1141186	1141186	19693121	5606052	4947288	292456	5239744	5824304	spneumo_pangenome_k32.r_0.2.S_eulertigs.k_17.d_na.M_default.C_xz
spneumo_pangenome_k32	0.2	eulertigs	17	na	ones	bzip	1434145	19693121	1494168	18198953	1196724	1141186	19693121	5606052	4947288	265930	5213218	5876208	spneumo_pangenome_k32.r_0.2.S_eulertigs.k_17.d_na.M_ones.C_bzip
spneumo_pangenome_k32	0.2	eulertigs	17	na	ones	xz	1434145	19693121	1494168	18198953	1196724	1141186	19693121	5606052	4947288	421536	5368824	5876208	spneumo_pangenome_k32.r_0.2.S_eulertigs.k_17.d_na.M_ones.C_xz
spneumo_pangenome_k32	0.2	eulertigs	17	na	runsapprox	bzip	1434145	19693121	1494168	18198953	1196724	1141186	19693121	5606052	4947288	265930	5213218	5876208	spneumo_pangenome_k32.r_0.2.S_eulertigs.k_17.d_na.M_runsapprox.C_bzip
spneumo_pangenome_k32	0.2	eulertigs	17	na	runsapprox	xz	1434145	19693121	1494168	18198953	1196724	1141186	19693121	5606052	4947288	421536	5368824	5876208	spneumo_pangenome_k32.r_0.2.S_eulertigs.k_17.d_na.M_runsapprox.C_xz
spneumo_pangenome_k32	0.3	eulertigs	17	na	default	bzip	2151218	26093554	2151218	23942336	1496396	1496396	26093554	7509996	6601032	320850	6921882	7779776	spneumo_pangenome_k32.r_0.3.S_eulertigs.k_17.d_na.M_default.C_bzip
spneumo_pangenome_k32	0.3	eulertigs	17	na	default	xz	2151218	26093554	2151218	23942336	1496396	1496396	26093554	7509996	6601032	510192	7111224	7779776	spneumo_pangenome_k32.r_0.3.S_eulertigs.k_17.d_na.M_default.C_xz
spneumo_pangenome_k32	0.3	eulertigs	17	na	ones	bzip	2151218	26093554	2270256	23823298	1601939	1496396	26093554	7509996	6601032	474706	7075738	7880728	spneumo_pangenome_k32.r_0.3.S_eulertigs.k_17.d_na.M_ones.C_bzip
spneumo_pangenome_k32	0.3	eulertigs	17	na	ones	xz	2151218	26093554	2270256	23823298	1601939	1496396	26093554	7509996	6601032	712932	7313964	7880728	spneumo_pangenome_k32.r_0.3.S_eulertigs.k_17.d_na.M_ones.C_xz
spneumo_pangenome_k32	0.3	eulertigs	17	na	runsapprox	bzip	2151218	26093554	2270256	23823298	1601939	1496396	26093554	7509996	6601032	474706	7075738	7880728	spneumo_pangenome_k32.r_0.3.S_eulertigs.k_17.d_na.M_runsapprox.C_bzip
spneumo_pangenome_k32	0.3	eulertigs	17	na	runsapprox	xz	2151218	26093554	2270256	23823298	1601939	1496396	26093554	7509996	6601032	712932	7313964	7880728	spneumo_pangenome_k32.r_0.3.S_eulertigs.k_17.d_na.M_runsapprox.C_xz
spneumo_pangenome_k32	0.4	eulertigs	17	na	default	bzip	2868290	30248386	2868290	27380096	1711256	1711256	30248386	8714772	7643308	459701	8103009	9094860	spneumo_pangenome_k32.r_0.4.S_eulertigs.k_17.d_na.M_default.C_bzip
spneumo_pangenome_k32	0.4	eulertigs	17	na	default	xz	2868290	30248386	2868290	27380096	1711256	1711256	30248386	8714772	7643308	711872	8355180	9094860	spneumo_pangenome_k32.r_0.4.S_eulertigs.k_17.d_na.M_default.C_xz
spneumo_pangenome_k32	0.4	eulertigs	17	na	ones	bzip	2868290	30248386	3053207	27195179	1867087	1711256	30248386	8714772	7643308	687782	8331090	9248776	spneumo_pangenome_k32.r_0.4.S_eulertigs.k_17.d_na.M_ones.C_bzip
spneumo_pangenome_k32	0.4	eulertigs	17	na	ones	xz	2868290	30248386	3053207	27195179	1867087	1711256	30248386	8714772	7643308	973124	8616432	9248776	spneumo_pangenome_k32.r_0.4.S_eulertigs.k_17.d_na.M_ones.C_xz
spneumo_pangenome_k32	0.4	eulertigs	17	na	runsapprox	bzip	2868290	30248386	3053207	27195179	1867087	1711256	30248386	8714772	7643308	687782	8331090	9248776	spneumo_pangenome_k32.r_0.4.S_eulertigs.k_17.d_na.M_runsapprox.C_bzip
spneumo_pangenome_k32	0.4	eulertigs	17	na	runsapprox	xz	2868290	30248386	3053207	27195179	1867087	1711256	30248386	8714772	7643308	973124	8616432	9248776	spneumo_pangenome_k32.r_0.4.S_eulertigs.k_17.d_na.M_runsapprox.C_xz
spneumo_pangenome_k32	0.5	eulertigs	17	na	default	bzip	3585363	32199251	3585363	28613888	1788368	1788368	32199251	9297032	8138472	582857	8721329	9764496	spneumo_pangenome_k32.r_0.5.S_eulertigs.k_17.d_na.M_default.C_bzip
spneumo_pangenome_k32	0.5	eulertigs	17	na	default	xz	3585363	32199251	3585363	28613888	1788368	1788368	32199251	9297032	8138472	867048	9005520	9764496	spneumo_pangenome_k32.r_0.5.S_eulertigs.k_17.d_na.M_default.C_xz
spneumo_pangenome_k32	0.5	eulertigs	17	na	ones	bzip	3585363	32199251	3831684	28367567	1984608	1788368	32199251	9297032	8138472	874545	9013017	9981276	spneumo_pangenome_k32.r_0.5.S_eulertigs.k_17.d_na.M_ones.C_bzip
spneumo_pangenome_k32	0.5	eulertigs	17	na	ones	xz	3585363	32199251	3831684	28367567	1984608	1788368	32199251	9297032	8138472	1167336	9305808	9981276	spneumo_pangenome_k32.r_0.5.S_eulertigs.k_17.d_na.M_ones.C_xz
spneumo_pangenome_k32	0.5	eulertigs	17	na	runsapprox	bzip	3585363	32199251	3831684	28367567	1984608	1788368	32199251	9297032	8138472	874545	9013017	9981276	spneumo_pangenome_k32.r_0.5.S_eulertigs.k_17.d_na.M_runsapprox.C_bzip
spneumo_pangenome_k32	0.5	eulertigs	17	na	runsapprox	xz	3585363	32199251	3831684	28367567	1984608	1788368	32199251	9297032	8138472	1167336	9305808	9981276	spneumo_pangenome_k32.r_0.5.S_eulertigs.k_17.d_na.M_runsapprox.C_xz
spneumo_pangenome_k32	0.6	eulertigs	17	na	default	bzip	4302436	31994772	4302436	27692336	1730771	1730771	31994772	9252900	8092972	670976	8763948	9796572	spneumo_pangenome_k32.r_0.6.S_eulertigs.k_17.d_na.M_default.C_bzip
spneumo_pangenome_k32	0.6	eulertigs	17	na	default	xz	4302436	31994772	4302436	27692336	1730771	1730771	31994772	9252900	8092972	952600	9045572	9796572	spneumo_pangenome_k32.r_0.6.S_eulertigs.k_17.d_na.M_default.C_xz
spneumo_pangenome_k32	0.6	eulertigs	17	na	ones	bzip	4302436	31994772	4595528	27399244	1948961	1730771	31994772	9252900	8092972	1003113	9096085	10031416	spneumo_pangenome_k32.r_0.6.S_eulertigs.k_17.d_na.M_ones.C_bzip
spneumo_pangenome_k32	0.6	eulertigs	17	na	ones	xz	4302436	31994772	4595528	27399244	1948961	1730771	31994772	9252900	8092972	1274544	9367516	10031416	spneumo_pangenome_k32.r_0.6.S_eulertigs.k_17.d_na.M_ones.C_xz
spneumo_pangenome_k32	0.6	eulertigs	17	na	runsapprox	bzip	4302436	31994772	4595528	27399244	1948961	1730771	31994772	9252900	8092972	1003113	9096085	10031416	spneumo_pangenome_k32.r_0.6.S_eulertigs.k_17.d_na.M_runsapprox.C_bzip
spneumo_pangenome_k32	0.6	eulertigs	17	na	runsapprox	xz	4302436	31994772	4595528	27399244	1948961	1730771	31994772	9252900	8092972	1274544	9367516	10031416	spneumo_pangenome_k32.r_0.6.S_eulertigs.k_17.d_na.M_runsapprox.C_xz
spneumo_pangenome_k32	0.7	eulertigs	17	na	default	bzip	5019508	29644020	5019508	24624512	1539032	1539032	29644020	8539804	7486920	699666	8186586	9154320	spneumo_pangenome_k32.r_0.7.S_eulertigs.k_17.d_na.M_default.C_bzip
spneumo_pangenome_k32	0.7	eulertigs	17	na	default	xz	5019508	29644020	5019508	24624512	1539032	1539032	29644020	8539804	7486920	951748	8438668	9154320	spneumo_pangenome_k32.r_0.7.S_eulertigs.k_17.d_na.M_default.C_xz
spneumo_pangenome_k32	0.7	eulertigs	17	na	ones	bzip	5019508	29644020	5336210	24307810	1754194	1539032	29644020	8539804	7486920	1041427	8528347	9406404	spneumo_pangenome_k32.r_0.7.S_eulertigs.k_17.d_na.M_ones.C_bzip
spneumo_pangenome_k32	0.7	eulertigs	17	na	ones	xz	5019508	29644020	5336210	24307810	1754194	1539032	29644020	8539804	7486920	1275972	8762892	9406404	spneumo_pangenome_k32.r_0.7.S_eulertigs.k_17.d_na.M_ones.C_xz
spneumo_pangenome_k32	0.7	eulertigs	17	na	runsapprox	bzip	5019508	29644020	5336210	24307810	1754194	1539032	29644020	8539804	7486920	1041427	8528347	9406404	spneumo_pangenome_k32.r_0.7.S_eulertigs.k_17.d_na.M_runsapprox.C_bzip
spneumo_pangenome_k32	0.7	eulertigs	17	na	runsapprox	xz	5019508	29644020	5336210	24307810	1754194	1539032	29644020	8539804	7486920	1275972	8762892	9406404	spneumo_pangenome_k32.r_0.7.S_eulertigs.k_17.d_na.M_runsapprox.C_xz
spneumo_pangenome_k32	0.8	eulertigs	17	na	default	bzip	5736581	25194613	5736581	19458032	1216127	1216127	25194613	7197516	6333004	652491	6985495	7877796	spneumo_pangenome_k32.r_0.8.S_eulertigs.k_17.d_na.M_default.C_bzip
spneumo_pangenome_k32	0.8	eulertigs	17	na	default	xz	5736581	25194613	5736581	19458032	1216127	1216127	25194613	7197516	6333004	859180	7192184	7877796	spneumo_pangenome_k32.r_0.8.S_eulertigs.k_17.d_na.M_default.C_xz
spneumo_pangenome_k32	0.8	eulertigs	17	na	ones	bzip	5736581	25194613	6042803	19151810	1397544	1216127	25194613	7197516	6333004	960848	7293852	8146252	spneumo_pangenome_k32.r_0.8.S_eulertigs.k_17.d_na.M_ones.C_bzip
spneumo_pangenome_k32	0.8	eulertigs	17	na	ones	xz	5736581	25194613	6042803	19151810	1397544	1216127	25194613	7197516	6333004	1153096	7486100	8146252	spneumo_pangenome_k32.r_0.8.S_eulertigs.k_17.d_na.M_ones.C_xz
spneumo_pangenome_k32	0.8	eulertigs	17	na	runsapprox	bzip	5736581	25194613	6042803	19151810	1397544	1216127	25194613	7197516	6333004	960848	7293852	8146252	spneumo_pangenome_k32.r_0.8.S_eulertigs.k_17.d_na.M_runsapprox.C_bzip
spneumo_pangenome_k32	0.8	eulertigs	17	na	runsapprox	xz	5736581	25194613	6042803	19151810	1397544	1216127	25194613	7197516	6333004	1153096	7486100	8146252	spneumo_pangenome_k32.r_0.8.S_eulertigs.k_17.d_na.M_runsapprox.C_xz
spneumo_pangenome_k32	0.9	eulertigs	17	na	default	bzip	6453654	18656950	6453654	12203296	762706	762706	18656950	5230840	4658376	494564	5152940	5876780	spneumo_pangenome_k32.r_0.9.S_eulertigs.k_17.d_na.M_default.C_bzip
spneumo_pangenome_k32	0.9	eulertigs	17	na	default	xz	6453654	18656950	6453654	12203296	762706	762706	18656950	5230840	4658376	652696	5311072	5876780	spneumo_pangenome_k32.r_0.9.S_eulertigs.k_17.d_na.M_default.C_xz
spneumo_pangenome_k32	0.9	eulertigs	17	na	ones	bzip	6453654	18656950	6706575	11950375	875697	762706	18656950	5230840	4658376	720375	5378751	6008148	spneumo_pangenome_k32.r_0.9.S_eulertigs.k_17.d_na.M_ones.C_bzip
spneumo_pangenome_k32	0.9	eulertigs	17	na	ones	xz	6453654	18656950	6706575	11950375	875697	762706	18656950	5230840	4658376	868824	5527200	6008148	spneumo_pangenome_k32.r_0.9.S_eulertigs.k_17.d_na.M_ones.C_xz
spneumo_pangenome_k32	0.9	eulertigs	17	na	runsapprox	bzip	6453654	18656950	6706575	11950375	875697	762706	18656950	5230840	4658376	720375	5378751	6008148	spneumo_pangenome_k32.r_0.9.S_eulertigs.k_17.d_na.M_runsapprox.C_bzip
spneumo_pangenome_k32	0.9	eulertigs	17	na	runsapprox	xz	6453654	18656950	6706575	11950375	875697	762706	18656950	5230840	4658376	868824	5527200	6008148	spneumo_pangenome_k32.r_0.9.S_eulertigs.k_17.d_na.M_runsapprox.C_xz
spneumo_pangenome_k32	1.0	eulertigs	17	na	default	bzip	7170727	10067399	7170727	2896672	181042	181042	10067399	2560140	2393484	151345	2544829	2874144	spneumo_pangenome_k32.r_1.0.S_eulertigs.k_17.d_na.M_default.C_bzip
spneumo_pangenome_k32	1.0	eulertigs	17	na	default	xz	7170727	10067399	7170727	2896672	181042	181042	10067399	2560140	2393484	239572	2633056	2874144	spneumo_pangenome_k32.r_1.0.S_eulertigs.k_17.d_na.M_default.C_xz
spneumo_pangenome_k32	1.0	eulertigs	17	na	ones	bzip	7170727	10067399	7321537	2745862	188042	181042	10067399	2560140	2393484	216531	2610015	2889192	spneumo_pangenome_k32.r_1.0.S_eulertigs.k_17.d_na.M_ones.C_bzip
spneumo_pangenome_k32	1.0	eulertigs	17	na	ones	xz	7170727	10067399	7321537	2745862	188042	181042	10067399	2560140	2393484	303244	2696728	2889192	spneumo_pangenome_k32.r_1.0.S_eulertigs.k_17.d_na.M_ones.C_xz
spneumo_pangenome_k32	1.0	eulertigs	17	na	runsapprox	bzip	7170727	10067399	7321537	2745862	188042	181042	10067399	2560140	2393484	216531	2610015	2889192	spneumo_pangenome_k32.r_1.0.S_eulertigs.k_17.d_na.M_runsapprox.C_bzip
spneumo_pangenome_k32	1.0	eulertigs	17	na	runsapprox	xz	7170727	10067399	7321537	2745862	188042	181042	10067399	2560140	2393484	303244	2696728	2889192	spneumo_pangenome_k32.r_1.0.S_eulertigs.k_17.d_na.M_runsapprox.C_xz
spneumo_pangenome_k32	0.000000001	greedytigs	17	na	default	bzip	1	17	1	16	1	1	17	84	84	41	125	84	spneumo_pangenome_k32.r_0.000000001.S_greedytigs.k_17.d_na.M_default.C_bzip
spneumo_pangenome_k32	0.000000001	greedytigs	17	na	default	xz	1	17	1	16	1	1	17	84	84	76	160	84	spneumo_pangenome_k32.r_0.000000001.S_greedytigs.k_17.d_na.M_default.C_xz
spneumo_pangenome_k32	0.000000001	greedytigs	17	na	ones	bzip	1	17	1	16	1	1	17	84	84	41	125	84	spneumo_pangenome_k32.r_0.000000001.S_greedytigs.k_17.d_na.M_ones.C_bzip
spneumo_pangenome_k32	0.000000001	greedytigs	17	na	ones	xz	1	17	1	16	1	1	17	84	84	76	160	84	spneumo_pangenome_k32.r_0.000000001.S_greedytigs.k_17.d_na.M_ones.C_xz
spneumo_pangenome_k32	0.000000001	greedytigs	17	na	runsapprox	bzip	1	17	1	16	1	1	17	84	84	41	125	84	spneumo_pangenome_k32.r_0.000000001.S_greedytigs.k_17.d_na.M_runsapprox.C_bzip
spneumo_pangenome_k32	0.000000001	greedytigs	17	na	runsapprox	xz	1	17	1	16	1	1	17	84	84	76	160	84	spneumo_pangenome_k32.r_0.000000001.S_greedytigs.k_17.d_na.M_runsapprox.C_xz
spneumo_pangenome_k32	0.0001	greedytigs	17	na	default	bzip	717	12189	717	11472	717	717	12189	3808	3564	47	3611	3776	spneumo_pangenome_k32.r_0.0001.S_greedytigs.k_17.d_na.M_default.C_bzip
spneumo_pangenome_k32	0.0001	greedytigs	17	na	default	xz	717	12189	717	11472	717	717	12189	3808	3564	124	3688	3776	spneumo_pangenome_k32.r_0.0001.S_greedytigs.k_17.d_na.M_default.C_xz
spneumo_pangenome_k32	0.0001	greedytigs	17	na	ones	bzip	717	12189	717	11472	717	717	12189	3808	3564	47	3611	3776	spneumo_pangenome_k32.r_0.0001.S_greedytigs.k_17.d_na.M_ones.C_bzip
spneumo_pangenome_k32	0.0001	greedytigs	17	na	ones	xz	717	12189	717	11472	717	717	12189	3808	3564	124	3688	3776	spneumo_pangenome_k32.r_0.0001.S_greedytigs.k_17.d_na.M_ones.C_xz
spneumo_pangenome_k32	0.0001	greedytigs	17	na	runsapprox	bzip	717	12189	717	11472	717	717	12189	3808	3564	47	3611	3776	spneumo_pangenome_k32.r_0.0001.S_greedytigs.k_17.d_na.M_runsapprox.C_bzip
spneumo_pangenome_k32	0.0001	greedytigs	17	na	runsapprox	xz	717	12189	717	11472	717	717	12189	3808	3564	124	3688	3776	spneumo_pangenome_k32.r_0.0001.S_greedytigs.k_17.d_na.M_runsapprox.C_xz
spneumo_pangenome_k32	0.001	greedytigs	17	na	default	bzip	7170	121762	7170	114592	7162	7162	121762	33816	31696	65	31761	33880	spneumo_pangenome_k32.r_0.001.S_greedytigs.k_17.d_na.M_default.C_bzip
spneumo_pangenome_k32	0.001	greedytigs	17	na	default	xz	7170	121762	7170	114592	7162	7162	121762	33816	31696	200	31896	33880	spneumo_pangenome_k32.r_0.001.S_greedytigs.k_17.d_na.M_default.C_xz
spneumo_pangenome_k32	0.001	greedytigs	17	na	ones	bzip	7170	121762	7171	114591	7163	7162	121762	33816	31696	70	31766	33880	spneumo_pangenome_k32.r_0.001.S_greedytigs.k_17.d_na.M_ones.C_bzip
spneumo_pangenome_k32	0.001	greedytigs	17	na	ones	xz	7170	121762	7171	114591	7163	7162	121762	33816	31696	208	31904	33880	spneumo_pangenome_k32.r_0.001.S_greedytigs.k_17.d_na.M_ones.C_xz
spneumo_pangenome_k32	0.001	greedytigs	17	na	runsapprox	bzip	7170	121762	7171	114591	7163	7162	121762	33816	31696	70	31766	33880	spneumo_pangenome_k32.r_0.001.S_greedytigs.k_17.d_na.M_runsapprox.C_bzip
spneumo_pangenome_k32	0.001	greedytigs	17	na	runsapprox	xz	7170	121762	7171	114591	7163	7162	121762	33816	31696	208	31904	33880	spneumo_pangenome_k32.r_0.001.S_greedytigs.k_17.d_na.M_runsapprox.C_xz
spneumo_pangenome_k32	0.01	greedytigs	17	na	default	bzip	71707	1207131	71707	1135424	70964	70964	1207131	342104	311140	1328	312468	347580	spneumo_pangenome_k32.r_0.01.S_greedytigs.k_17.d_na.M_default.C_bzip
spneumo_pangenome_k32	0.01	greedytigs	17	na	default	xz	71707	1207131	71707	1135424	70964	70964	1207131	342104	311140	2352	313492	347580	spneumo_pangenome_k32.r_0.01.S_greedytigs.k_17.d_na.M_default.C_xz
spneumo_pangenome_k32	0.01	greedytigs	17	na	ones	bzip	71707	1207131	71898	1135233	71155	70964	1207131	342104	311140	1746	312886	347540	spneumo_pangenome_k32.r_0.01.S_greedytigs.k_17.d_na.M_ones.C_bzip
spneumo_pangenome_k32	0.01	greedytigs	17	na	ones	xz	71707	1207131	71898	1135233	71155	70964	1207131	342104	311140	3280	314420	347540	spneumo_pangenome_k32.r_0.01.S_greedytigs.k_17.d_na.M_ones.C_xz
spneumo_pangenome_k32	0.01	greedytigs	17	na	runsapprox	bzip	71707	1207131	71898	1135233	71155	70964	1207131	342104	311140	1746	312886	347540	spneumo_pangenome_k32.r_0.01.S_greedytigs.k_17.d_na.M_runsapprox.C_bzip
spneumo_pangenome_k32	0.01	greedytigs	17	na	runsapprox	xz	71707	1207131	71898	1135233	71155	70964	1207131	342104	311140	3280	314420	347540	spneumo_pangenome_k32.r_0.01.S_greedytigs.k_17.d_na.M_runsapprox.C_xz
spneumo_pangenome_k32	0.05	greedytigs	17	na	default	bzip	358536	5800104	358536	5441568	340098	340098	5800104	1651216	1477244	21821	1499065	1684656	spneumo_pangenome_k32.r_0.05.S_greedytigs.k_17.d_na.M_default.C_bzip
spneumo_pangenome_k32	0.05	greedytigs	17	na	default	xz	358536	5800104	358536	5441568	340098	340098	5800104	1651216	1477244	34396	1511640	1684656	spneumo_pangenome_k32.r_0.05.S_greedytigs.k_17.d_na.M_default.C_xz
spneumo_pangenome_k32	0.05	greedytigs	17	na	ones	bzip	358536	5800104	362936	5437168	344400	340098	5800104	1651216	1477244	29343	1506587	1686560	spneumo_pangenome_k32.r_0.05.S_greedytigs.k_17.d_na.M_ones.C_bzip
spneumo_pangenome_k32	0.05	greedytigs	17	na	ones	xz	358536	5800104	362936	5437168	344400	340098	5800104	1651216	1477244	49168	1526412	1686560	spneumo_pangenome_k32.r_0.05.S_greedytigs.k_17.d_na.M_ones.C_xz
spneumo_pangenome_k32	0.05	greedytigs	17	na	runsapprox	bzip	358536	5800104	362936	5437168	344400	340098	5800104	1651216	1477244	29343	1506587	1686560	spneumo_pangenome_k32.r_0.05.S_greedytigs.k_17.d_na.M_runsapprox.C_bzip
spneumo_pangenome_k32	0.05	greedytigs	17	na	runsapprox	xz	358536	5800104	362936	5437168	344400	340098	5800104	1651216	1477244	49168	1526412	1686560	spneumo_pangenome_k32.r_0.05.S_greedytigs.k_17.d_na.M_runsapprox.C_xz
spneumo_pangenome_k32	0.1	greedytigs	17	na	default	bzip	717072	11008898	717074	10291824	643239	643239	11008898	3134196	2780824	65739	2846563	3222744	spneumo_pangenome_k32.r_0.1.S_greedytigs.k_17.d_na.M_default.C_bzip
spneumo_pangenome_k32	0.1	greedytigs	17	na	default	xz	717072	11008898	717074	10291824	643239	643239	11008898	3134196	2780824	103164	2883988	3222744	spneumo_pangenome_k32.r_0.1.S_greedytigs.k_17.d_na.M_default.C_xz
spneumo_pangenome_k32	0.1	greedytigs	17	na	ones	bzip	717072	11008898	734095	10274803	659633	643239	11008898	3134196	2780824	91985	2872809	3238876	spneumo_pangenome_k32.r_0.1.S_greedytigs.k_17.d_na.M_ones.C_bzip
spneumo_pangenome_k32	0.1	greedytigs	17	na	ones	xz	717072	11008898	734095	10274803	659633	643239	11008898	3134196	2780824	151088	2931912	3238876	spneumo_pangenome_k32.r_0.1.S_greedytigs.k_17.d_na.M_ones.C_xz
spneumo_pangenome_k32	0.1	greedytigs	17	na	runsapprox	bzip	717072	11008898	734095	10274803	659633	643239	11008898	3134196	2780824	91985	2872809	3238876	spneumo_pangenome_k32.r_0.1.S_greedytigs.k_17.d_na.M_runsapprox.C_bzip
spneumo_pangenome_k32	0.1	greedytigs	17	na	runsapprox	xz	717072	11008898	734095	10274803	659633	643239	11008898	3134196	2780824	151088	2931912	3238876	spneumo_pangenome_k32.r_0.1.S_greedytigs.k_17.d_na.M_runsapprox.C_xz
spneumo_pangenome_k32	0.2	greedytigs	17	na	default	bzip	1434145	19692853	1434165	18258688	1141168	1141168	19692853	5605932	4946764	183038	5129802	5823144	spneumo_pangenome_k32.r_0.2.S_greedytigs.k_17.d_na.M_default.C_bzip
spneumo_pangenome_k32	0.2	greedytigs	17	na	default	xz	1434145	19692853	1434165	18258688	1141168	1141168	19692853	5605932	4946764	292924	5239688	5823144	spneumo_pangenome_k32.r_0.2.S_greedytigs.k_17.d_na.M_default.C_xz
spneumo_pangenome_k32	0.2	greedytigs	17	na	ones	bzip	1434145	19692853	1494672	18198181	1197132	1141168	19692853	5605932	4946764	266598	5213362	5875040	spneumo_pangenome_k32.r_0.2.S_greedytigs.k_17.d_na.M_ones.C_bzip
spneumo_pangenome_k32	0.2	greedytigs	17	na	ones	xz	1434145	19692853	1494672	18198181	1197132	1141168	19692853	5605932	4946764	422924	5369688	5875040	spneumo_pangenome_k32.r_0.2.S_greedytigs.k_17.d_na.M_ones.C_xz
spneumo_pangenome_k32	0.2	greedytigs	17	na	runsapprox	bzip	1434145	19692853	1494672	18198181	1197132	1141168	19692853	5605932	4946764	266598	5213362	5875040	spneumo_pangenome_k32.r_0.2.S_greedytigs.k_17.d_na.M_runsapprox.C_bzip
spneumo_pangenome_k32	0.2	greedytigs	17	na	runsapprox	xz	1434145	19692853	1494672	18198181	1197132	1141168	19692853	5605932	4946764	422924	5369688	5875040	spneumo_pangenome_k32.r_0.2.S_greedytigs.k_17.d_na.M_runsapprox.C_xz
spneumo_pangenome_k32	0.3	greedytigs	17	na	default	bzip	2151218	26091555	2151395	23940160	1496260	1496260	26091555	7507048	6601608	320948	6922556	7778172	spneumo_pangenome_k32.r_0.3.S_greedytigs.k_17.d_na.M_default.C_bzip
spneumo_pangenome_k32	0.3	greedytigs	17	na	default	xz	2151218	26091555	2151395	23940160	1496260	1496260	26091555	7507048	6601608	510140	7111748	7778172	spneumo_pangenome_k32.r_0.3.S_greedytigs.k_17.d_na.M_default.C_xz
spneumo_pangenome_k32	0.3	greedytigs	17	na	ones	bzip	2151218	26091555	2271571	23819984	1602671	1496260	26091555	7507048	6601608	476164	7077772	7881612	spneumo_pangenome_k32.r_0.3.S_greedytigs.k_17.d_na.M_ones.C_bzip
spneumo_pangenome_k32	0.3	greedytigs	17	na	ones	xz	2151218	26091555	2271571	23819984	1602671	1496260	26091555	7507048	6601608	714692	7316300	7881612	spneumo_pangenome_k32.r_0.3.S_greedytigs.k_17.d_na.M_ones.C_xz
spneumo_pangenome_k32	0.3	greedytigs	17	na	runsapprox	bzip	2151218	26091555	2271571	23819984	1602671	1496260	26091555	7507048	6601608	476164	7077772	7881612	spneumo_pangenome_k32.r_0.3.S_greedytigs.k_17.d_na.M_runsapprox.C_bzip
spneumo_pangenome_k32	0.3	greedytigs	17	na	runsapprox	xz	2151218	26091555	2271571	23819984	1602671	1496260	26091555	7507048	6601608	714692	7316300	7881612	spneumo_pangenome_k32.r_0.3.S_greedytigs.k_17.d_na.M_runsapprox.C_xz
spneumo_pangenome_k32	0.4	greedytigs	17	na	default	bzip	2868290	30240703	2869055	27371648	1710728	1710728	30240703	8713664	7641000	460177	8101177	9095260	spneumo_pangenome_k32.r_0.4.S_greedytigs.k_17.d_na.M_default.C_bzip
spneumo_pangenome_k32	0.4	greedytigs	17	na	default	xz	2868290	30240703	2869055	27371648	1710728	1710728	30240703	8713664	7641000	711892	8352892	9095260	spneumo_pangenome_k32.r_0.4.S_greedytigs.k_17.d_na.M_default.C_xz
spneumo_pangenome_k32	0.4	greedytigs	17	na	ones	bzip	2868290	30240703	3053375	27187328	1866479	1710728	30240703	8713664	7641000	687303	8328303	9246632	spneumo_pangenome_k32.r_0.4.S_greedytigs.k_17.d_na.M_ones.C_bzip
spneumo_pangenome_k32	0.4	greedytigs	17	na	ones	xz	2868290	30240703	3053375	27187328	1866479	1710728	30240703	8713664	7641000	972360	8613360	9246632	spneumo_pangenome_k32.r_0.4.S_greedytigs.k_17.d_na.M_ones.C_xz
spneumo_pangenome_k32	0.4	greedytigs	17	na	runsapprox	bzip	2868290	30240703	3053375	27187328	1866479	1710728	30240703	8713664	7641000	687303	8328303	9246632	spneumo_pangenome_k32.r_0.4.S_greedytigs.k_17.d_na.M_runsapprox.C_bzip
spneumo_pangenome_k32	0.4	greedytigs	17	na	runsapprox	xz	2868290	30240703	3053375	27187328	1866479	1710728	30240703	8713664	7641000	972360	8613360	9246632	spneumo_pangenome_k32.r_0.4.S_greedytigs.k_17.d_na.M_runsapprox.C_xz
spneumo_pangenome_k32	0.5	greedytigs	17	na	default	bzip	3585363	32176453	3587973	28588480	1786780	1786780	32176453	9292104	8134708	583170	8717878	9738292	spneumo_pangenome_k32.r_0.5.S_greedytigs.k_17.d_na.M_default.C_bzip
spneumo_pangenome_k32	0.5	greedytigs	17	na	default	xz	3585363	32176453	3587973	28588480	1786780	1786780	32176453	9292104	8134708	867476	9002184	9738292	spneumo_pangenome_k32.r_0.5.S_greedytigs.k_17.d_na.M_default.C_xz
spneumo_pangenome_k32	0.5	greedytigs	17	na	ones	bzip	3585363	32176453	3832392	28344061	1982535	1786780	32176453	9292104	8134708	873367	9008075	9961796	spneumo_pangenome_k32.r_0.5.S_greedytigs.k_17.d_na.M_ones.C_bzip
spneumo_pangenome_k32	0.5	greedytigs	17	na	ones	xz	3585363	32176453	3832392	28344061	1982535	1786780	32176453	9292104	8134708	1166176	9300884	9961796	spneumo_pangenome_k32.r_0.5.S_greedytigs.k_17.d_na.M_ones.C_xz
spneumo_pangenome_k32	0.5	greedytigs	17	na	runsapprox	bzip	3585363	32176453	3832392	28344061	1982535	1786780	32176453	9292104	8134708	873367	9008075	9961796	spneumo_pangenome_k32.r_0.5.S_greedytigs.k_17.d_na.M_runsapprox.C_bzip
spneumo_pangenome_k32	0.5	greedytigs	17	na	runsapprox	xz	3585363	32176453	3832392	28344061	1982535	1786780	32176453	9292104	8134708	1166176	9300884	9961796	spneumo_pangenome_k32.r_0.5.S_greedytigs.k_17.d_na.M_runsapprox.C_xz
spneumo_pangenome_k32	0.6	greedytigs	17	na	default	bzip	4302436	31937071	4310895	27626176	1726636	1726636	31937071	9239760	8085272	671903	8757175	9778008	spneumo_pangenome_k32.r_0.6.S_greedytigs.k_17.d_na.M_default.C_bzip
spneumo_pangenome_k32	0.6	greedytigs	17	na	default	xz	4302436	31937071	4310895	27626176	1726636	1726636	31937071	9239760	8085272	952696	9037968	9778008	spneumo_pangenome_k32.r_0.6.S_greedytigs.k_17.d_na.M_default.C_xz
spneumo_pangenome_k32	0.6	greedytigs	17	na	ones	bzip	4302436	31937071	4599708	27337363	1943884	1726636	31937071	9239760	8085272	999543	9084815	10014640	spneumo_pangenome_k32.r_0.6.S_greedytigs.k_17.d_na.M_ones.C_bzip
spneumo_pangenome_k32	0.6	greedytigs	17	na	ones	xz	4302436	31937071	4599708	27337363	1943884	1726636	31937071	9239760	8085272	1270948	9356220	10014640	spneumo_pangenome_k32.r_0.6.S_greedytigs.k_17.d_na.M_ones.C_xz
spneumo_pangenome_k32	0.6	greedytigs	17	na	runsapprox	bzip	4302436	31937071	4599708	27337363	1943884	1726636	31937071	9239760	8085272	999543	9084815	10014640	spneumo_pangenome_k32.r_0.6.S_greedytigs.k_17.d_na.M_runsapprox.C_bzip
spneumo_pangenome_k32	0.6	greedytigs	17	na	runsapprox	xz	4302436	31937071	4599708	27337363	1943884	1726636	31937071	9239760	8085272	1270948	9356220	10014640	spneumo_pangenome_k32.r_0.6.S_greedytigs.k_17.d_na.M_runsapprox.C_xz
spneumo_pangenome_k32	0.7	greedytigs	17	na	default	bzip	5019508	29517377	5043617	24473760	1529610	1529610	29517377	8510280	7458160	699571	8157731	9122228	spneumo_pangenome_k32.r_0.7.S_greedytigs.k_17.d_na.M_default.C_bzip
spneumo_pangenome_k32	0.7	greedytigs	17	na	default	xz	5019508	29517377	5043617	24473760	1529610	1529610	29517377	8510280	7458160	950112	8408272	9122228	spneumo_pangenome_k32.r_0.7.S_greedytigs.k_17.d_na.M_default.C_xz
spneumo_pangenome_k32	0.7	greedytigs	17	na	ones	bzip	5019508	29517377	5352538	24164839	1744436	1529610	29517377	8510280	7458160	1035214	8493374	9371820	spneumo_pangenome_k32.r_0.7.S_greedytigs.k_17.d_na.M_ones.C_bzip
spneumo_pangenome_k32	0.7	greedytigs	17	na	ones	xz	5019508	29517377	5352538	24164839	1744436	1529610	29517377	8510280	7458160	1269492	8727652	9371820	spneumo_pangenome_k32.r_0.7.S_greedytigs.k_17.d_na.M_ones.C_xz
spneumo_pangenome_k32	0.7	greedytigs	17	na	runsapprox	bzip	5019508	29517377	5352538	24164839	1744436	1529610	29517377	8510280	7458160	1035214	8493374	9371820	spneumo_pangenome_k32.r_0.7.S_greedytigs.k_17.d_na.M_runsapprox.C_bzip
spneumo_pangenome_k32	0.7	greedytigs	17	na	runsapprox	xz	5019508	29517377	5352538	24164839	1744436	1529610	29517377	8510280	7458160	1269492	8727652	9371820	spneumo_pangenome_k32.r_0.7.S_greedytigs.k_17.d_na.M_runsapprox.C_xz
spneumo_pangenome_k32	0.8	greedytigs	17	na	default	bzip	5736581	24938052	5808964	19129088	1195568	1195568	24938052	7129964	6279768	648380	6928148	7814748	spneumo_pangenome_k32.r_0.8.S_greedytigs.k_17.d_na.M_default.C_bzip
spneumo_pangenome_k32	0.8	greedytigs	17	na	default	xz	5736581	24938052	5808964	19129088	1195568	1195568	24938052	7129964	6279768	852588	7132356	7814748	spneumo_pangenome_k32.r_0.8.S_greedytigs.k_17.d_na.M_default.C_xz
spneumo_pangenome_k32	0.8	greedytigs	17	na	ones	bzip	5736581	24938052	6097128	18840924	1375900	1195568	24938052	7129964	6279768	943473	7223241	8077528	spneumo_pangenome_k32.r_0.8.S_greedytigs.k_17.d_na.M_ones.C_bzip
spneumo_pangenome_k32	0.8	greedytigs	17	na	ones	xz	5736581	24938052	6097128	18840924	1375900	1195568	24938052	7129964	6279768	1135992	7415760	8077528	spneumo_pangenome_k32.r_0.8.S_greedytigs.k_17.d_na.M_ones.C_xz
spneumo_pangenome_k32	0.8	greedytigs	17	na	runsapprox	bzip	5736581	24938052	6097128	18840924	1375900	1195568	24938052	7129964	6279768	943473	7223241	8077528	spneumo_pangenome_k32.r_0.8.S_greedytigs.k_17.d_na.M_runsapprox.C_bzip
spneumo_pangenome_k32	0.8	greedytigs	17	na	runsapprox	xz	5736581	24938052	6097128	18840924	1375900	1195568	24938052	7129964	6279768	1135992	7415760	8077528	spneumo_pangenome_k32.r_0.8.S_greedytigs.k_17.d_na.M_runsapprox.C_xz
spneumo_pangenome_k32	0.9	greedytigs	17	na	default	bzip	6453654	18162560	6677552	11485008	717813	717813	18162560	5079948	4534932	477471	5012403	5710304	spneumo_pangenome_k32.r_0.9.S_greedytigs.k_17.d_na.M_default.C_bzip
spneumo_pangenome_k32	0.9	greedytigs	17	na	default	xz	6453654	18162560	6677552	11485008	717813	717813	18162560	5079948	4534932	633880	5168812	5710304	spneumo_pangenome_k32.r_0.9.S_greedytigs.k_17.d_na.M_default.C_xz
spneumo_pangenome_k32	0.9	greedytigs	17	na	ones	bzip	6453654	18162560	6890387	11272173	827991	717813	18162560	5079948	4534932	681098	5216030	5836028	spneumo_pangenome_k32.r_0.9.S_greedytigs.k_17.d_na.M_ones.C_bzip
spneumo_pangenome_k32	0.9	greedytigs	17	na	ones	xz	6453654	18162560	6890387	11272173	827991	717813	18162560	5079948	4534932	829988	5364920	5836028	spneumo_pangenome_k32.r_0.9.S_greedytigs.k_17.d_na.M_ones.C_xz
spneumo_pangenome_k32	0.9	greedytigs	17	na	runsapprox	bzip	6453654	18162560	6890387	11272173	827991	717813	18162560	5079948	4534932	681098	5216030	5836028	spneumo_pangenome_k32.r_0.9.S_greedytigs.k_17.d_na.M_runsapprox.C_bzip
spneumo_pangenome_k32	0.9	greedytigs	17	na	runsapprox	xz	6453654	18162560	6890387	11272173	827991	717813	18162560	5079948	4534932	829988	5364920	5836028	spneumo_pangenome_k32.r_0.9.S_greedytigs.k_17.d_na.M_runsapprox.C_xz
spneumo_pangenome_k32	1.0	greedytigs	17	na	default	bzip	7170727	9145063	7880759	1264304	79019	79019	9145063	2134108	2046824	82532	2129356	2325284	spneumo_pangenome_k32.r_1.0.S_greedytigs.k_17.d_na.M_default.C_bzip
spneumo_pangenome_k32	1.0	greedytigs	17	na	default	xz	7170727	9145063	7880759	1264304	79019	79019	9145063	2134108	2046824	152252	2199076	2325284	spneumo_pangenome_k32.r_1.0.S_greedytigs.k_17.d_na.M_default.C_xz
spneumo_pangenome_k32	1.0	greedytigs	17	na	ones	bzip	7170727	9145063	7941783	1203280	81610	79019	9145063	2134108	2046824	107892	2154716	2328208	spneumo_pangenome_k32.r_1.0.S_greedytigs.k_17.d_na.M_ones.C_bzip
spneumo_pangenome_k32	1.0	greedytigs	17	na	ones	xz	7170727	9145063	7941783	1203280	81610	79019	9145063	2134108	2046824	177708	2224532	2328208	spneumo_pangenome_k32.r_1.0.S_greedytigs.k_17.d_na.M_ones.C_xz
spneumo_pangenome_k32	1.0	greedytigs	17	na	runsapprox	bzip	7170727	9145063	7938248	1206815	79019	79019	9145063	2134108	2046824	102551	2149375	2324692	spneumo_pangenome_k32.r_1.0.S_greedytigs.k_17.d_na.M_runsapprox.C_bzip
spneumo_pangenome_k32	1.0	greedytigs	17	na	runsapprox	xz	7170727	9145063	7938248	1206815	79019	79019	9145063	2134108	2046824	172068	2218892	2324692	spneumo_pangenome_k32.r_1.0.S_greedytigs.k_17.d_na.M_runsapprox.C_xz
spneumo_pangenome_k32	0.000000001	prophasm	17	na	default	bzip	1	17	1	16	1	1	17	84	84	41	125	84	spneumo_pangenome_k32.r_0.000000001.S_prophasm.k_17.d_na.M_default.C_bzip
spneumo_pangenome_k32	0.000000001	prophasm	17	na	default	xz	1	17	1	16	1	1	17	84	84	76	160	84	spneumo_pangenome_k32.r_0.000000001.S_prophasm.k_17.d_na.M_default.C_xz
spneumo_pangenome_k32	0.000000001	prophasm	17	na	ones	bzip	1	17	1	16	1	1	17	84	84	41	125	84	spneumo_pangenome_k32.r_0.000000001.S_prophasm.k_17.d_na.M_ones.C_bzip
spneumo_pangenome_k32	0.000000001	prophasm	17	na	ones	xz	1	17	1	16	1	1	17	84	84	76	160	84	spneumo_pangenome_k32.r_0.000000001.S_prophasm.k_17.d_na.M_ones.C_xz
spneumo_pangenome_k32	0.000000001	prophasm	17	na	runsapprox	bzip	1	17	1	16	1	1	17	84	84	41	125	84	spneumo_pangenome_k32.r_0.000000001.S_prophasm.k_17.d_na.M_runsapprox.C_bzip
spneumo_pangenome_k32	0.000000001	prophasm	17	na	runsapprox	xz	1	17	1	16	1	1	17	84	84	76	160	84	spneumo_pangenome_k32.r_0.000000001.S_prophasm.k_17.d_na.M_runsapprox.C_xz
spneumo_pangenome_k32	0.0001	prophasm	17	na	default	bzip	717	12189	717	11472	717	717	12189	4140	3676	47	3723	4224	spneumo_pangenome_k32.r_0.0001.S_prophasm.k_17.d_na.M_default.C_bzip
spneumo_pangenome_k32	0.0001	prophasm	17	na	default	xz	717	12189	717	11472	717	717	12189	4140	3676	124	3800	4224	spneumo_pangenome_k32.r_0.0001.S_prophasm.k_17.d_na.M_default.C_xz
spneumo_pangenome_k32	0.0001	prophasm	17	na	ones	bzip	717	12189	717	11472	717	717	12189	4140	3676	47	3723	4224	spneumo_pangenome_k32.r_0.0001.S_prophasm.k_17.d_na.M_ones.C_bzip
spneumo_pangenome_k32	0.0001	prophasm	17	na	ones	xz	717	12189	717	11472	717	717	12189	4140	3676	124	3800	4224	spneumo_pangenome_k32.r_0.0001.S_prophasm.k_17.d_na.M_ones.C_xz
spneumo_pangenome_k32	0.0001	prophasm	17	na	runsapprox	bzip	717	12189	717	11472	717	717	12189	4140	3676	47	3723	4224	spneumo_pangenome_k32.r_0.0001.S_prophasm.k_17.d_na.M_runsapprox.C_bzip
spneumo_pangenome_k32	0.0001	prophasm	17	na	runsapprox	xz	717	12189	717	11472	717	717	12189	4140	3676	124	3800	4224	spneumo_pangenome_k32.r_0.0001.S_prophasm.k_17.d_na.M_runsapprox.C_xz
spneumo_pangenome_k32	0.001	prophasm	17	na	default	bzip	7170	121762	7170	114592	7162	7162	121762	37772	33424	65	33489	38440	spneumo_pangenome_k32.r_0.001.S_prophasm.k_17.d_na.M_default.C_bzip
spneumo_pangenome_k32	0.001	prophasm	17	na	default	xz	7170	121762	7170	114592	7162	7162	121762	37772	33424	200	33624	38440	spneumo_pangenome_k32.r_0.001.S_prophasm.k_17.d_na.M_default.C_xz
spneumo_pangenome_k32	0.001	prophasm	17	na	ones	bzip	7170	121762	7172	114590	7164	7162	121762	37772	33424	72	33496	38440	spneumo_pangenome_k32.r_0.001.S_prophasm.k_17.d_na.M_ones.C_bzip
spneumo_pangenome_k32	0.001	prophasm	17	na	ones	xz	7170	121762	7172	114590	7164	7162	121762	37772	33424	212	33636	38440	spneumo_pangenome_k32.r_0.001.S_prophasm.k_17.d_na.M_ones.C_xz
spneumo_pangenome_k32	0.001	prophasm	17	na	runsapprox	bzip	7170	121762	7172	114590	7164	7162	121762	37772	33424	72	33496	38440	spneumo_pangenome_k32.r_0.001.S_prophasm.k_17.d_na.M_runsapprox.C_bzip
spneumo_pangenome_k32	0.001	prophasm	17	na	runsapprox	xz	7170	121762	7172	114590	7164	7162	121762	37772	33424	212	33636	38440	spneumo_pangenome_k32.r_0.001.S_prophasm.k_17.d_na.M_runsapprox.C_xz
spneumo_pangenome_k32	0.01	prophasm	17	na	default	bzip	71707	1207131	71707	1135424	70964	70964	1207131	360664	317700	1303	319003	364960	spneumo_pangenome_k32.r_0.01.S_prophasm.k_17.d_na.M_default.C_bzip
spneumo_pangenome_k32	0.01	prophasm	17	na	default	xz	71707	1207131	71707	1135424	70964	70964	1207131	360664	317700	2372	320072	364960	spneumo_pangenome_k32.r_0.01.S_prophasm.k_17.d_na.M_default.C_xz
spneumo_pangenome_k32	0.01	prophasm	17	na	ones	bzip	71707	1207131	71896	1135235	71151	70964	1207131	360664	317700	1744	319444	358828	spneumo_pangenome_k32.r_0.01.S_prophasm.k_17.d_na.M_ones.C_bzip
spneumo_pangenome_k32	0.01	prophasm	17	na	ones	xz	71707	1207131	71896	1135235	71151	70964	1207131	360664	317700	3180	320880	358828	spneumo_pangenome_k32.r_0.01.S_prophasm.k_17.d_na.M_ones.C_xz
spneumo_pangenome_k32	0.01	prophasm	17	na	runsapprox	bzip	71707	1207131	71896	1135235	71151	70964	1207131	360664	317700	1744	319444	358828	spneumo_pangenome_k32.r_0.01.S_prophasm.k_17.d_na.M_runsapprox.C_bzip
spneumo_pangenome_k32	0.01	prophasm	17	na	runsapprox	xz	71707	1207131	71896	1135235	71151	70964	1207131	360664	317700	3180	320880	358828	spneumo_pangenome_k32.r_0.01.S_prophasm.k_17.d_na.M_runsapprox.C_xz
spneumo_pangenome_k32	0.05	prophasm	17	na	default	bzip	358536	5800104	358536	5441568	340098	340098	5800104	1706648	1504420	20585	1525005	1704448	spneumo_pangenome_k32.r_0.05.S_prophasm.k_17.d_na.M_default.C_bzip
spneumo_pangenome_k32	0.05	prophasm	17	na	default	xz	358536	5800104	358536	5441568	340098	340098	5800104	1706648	1504420	32516	1536936	1704448	spneumo_pangenome_k32.r_0.05.S_prophasm.k_17.d_na.M_default.C_xz
spneumo_pangenome_k32	0.05	prophasm	17	na	ones	bzip	358536	5800104	363167	5436937	344646	340098	5800104	1706648	1504420	28537	1532957	1708576	spneumo_pangenome_k32.r_0.05.S_prophasm.k_17.d_na.M_ones.C_bzip
spneumo_pangenome_k32	0.05	prophasm	17	na	ones	xz	358536	5800104	363167	5436937	344646	340098	5800104	1706648	1504420	48340	1552760	1708576	spneumo_pangenome_k32.r_0.05.S_prophasm.k_17.d_na.M_ones.C_xz
spneumo_pangenome_k32	0.05	prophasm	17	na	runsapprox	bzip	358536	5800104	363167	5436937	344646	340098	5800104	1706648	1504420	28537	1532957	1708576	spneumo_pangenome_k32.r_0.05.S_prophasm.k_17.d_na.M_runsapprox.C_bzip
spneumo_pangenome_k32	0.05	prophasm	17	na	runsapprox	xz	358536	5800104	363167	5436937	344646	340098	5800104	1706648	1504420	48340	1552760	1708576	spneumo_pangenome_k32.r_0.05.S_prophasm.k_17.d_na.M_runsapprox.C_xz
spneumo_pangenome_k32	0.1	prophasm	17	na	default	bzip	717072	11008928	717072	10291856	643241	643241	11008928	3222268	2838280	61583	2899863	3242148	spneumo_pangenome_k32.r_0.1.S_prophasm.k_17.d_na.M_default.C_bzip
spneumo_pangenome_k32	0.1	prophasm	17	na	default	xz	717072	11008928	717072	10291856	643241	643241	11008928	3222268	2838280	97388	2935668	3242148	spneumo_pangenome_k32.r_0.1.S_prophasm.k_17.d_na.M_default.C_xz
spneumo_pangenome_k32	0.1	prophasm	17	na	ones	bzip	717072	11008928	734837	10274091	660301	643241	11008928	3222268	2838280	88800	2927080	3259588	spneumo_pangenome_k32.r_0.1.S_prophasm.k_17.d_na.M_ones.C_bzip
spneumo_pangenome_k32	0.1	prophasm	17	na	ones	xz	717072	11008928	734837	10274091	660301	643241	11008928	3222268	2838280	148280	2986560	3259588	spneumo_pangenome_k32.r_0.1.S_prophasm.k_17.d_na.M_ones.C_xz
spneumo_pangenome_k32	0.1	prophasm	17	na	runsapprox	bzip	717072	11008928	734837	10274091	660301	643241	11008928	3222268	2838280	88800	2927080	3259588	spneumo_pangenome_k32.r_0.1.S_prophasm.k_17.d_na.M_runsapprox.C_bzip
spneumo_pangenome_k32	0.1	prophasm	17	na	runsapprox	xz	717072	11008928	734837	10274091	660301	643241	11008928	3222268	2838280	148280	2986560	3259588	spneumo_pangenome_k32.r_0.1.S_prophasm.k_17.d_na.M_runsapprox.C_xz
spneumo_pangenome_k32	0.2	prophasm	17	na	default	bzip	1434145	19693121	1434145	18258976	1141186	1141186	19693121	5737828	5050092	171924	5222016	5835132	spneumo_pangenome_k32.r_0.2.S_prophasm.k_17.d_na.M_default.C_bzip
spneumo_pangenome_k32	0.2	prophasm	17	na	default	xz	1434145	19693121	1434145	18258976	1141186	1141186	19693121	5737828	5050092	274696	5324788	5835132	spneumo_pangenome_k32.r_0.2.S_prophasm.k_17.d_na.M_default.C_xz
spneumo_pangenome_k32	0.2	prophasm	17	na	ones	bzip	1434145	19693121	1497288	18195833	1199449	1141186	19693121	5737828	5050092	258561	5308653	5895376	spneumo_pangenome_k32.r_0.2.S_prophasm.k_17.d_na.M_ones.C_bzip
spneumo_pangenome_k32	0.2	prophasm	17	na	ones	xz	1434145	19693121	1497288	18195833	1199449	1141186	19693121	5737828	5050092	413048	5463140	5895376	spneumo_pangenome_k32.r_0.2.S_prophasm.k_17.d_na.M_ones.C_xz
spneumo_pangenome_k32	0.2	prophasm	17	na	runsapprox	bzip	1434145	19693121	1497288	18195833	1199449	1141186	19693121	5737828	5050092	258561	5308653	5895376	spneumo_pangenome_k32.r_0.2.S_prophasm.k_17.d_na.M_runsapprox.C_bzip
spneumo_pangenome_k32	0.2	prophasm	17	na	runsapprox	xz	1434145	19693121	1497288	18195833	1199449	1141186	19693121	5737828	5050092	413048	5463140	5895376	spneumo_pangenome_k32.r_0.2.S_prophasm.k_17.d_na.M_runsapprox.C_xz
spneumo_pangenome_k32	0.3	prophasm	17	na	default	bzip	2151218	26093554	2151218	23942336	1496396	1496396	26093554	7586020	6665236	300595	6965831	7773616	spneumo_pangenome_k32.r_0.3.S_prophasm.k_17.d_na.M_default.C_bzip
spneumo_pangenome_k32	0.3	prophasm	17	na	default	xz	2151218	26093554	2151218	23942336	1496396	1496396	26093554	7586020	6665236	471916	7137152	7773616	spneumo_pangenome_k32.r_0.3.S_prophasm.k_17.d_na.M_default.C_xz
spneumo_pangenome_k32	0.3	prophasm	17	na	ones	bzip	2151218	26093554	2274713	23818841	1605747	1496396	26093554	7586020	6665236	460356	7125592	7895724	spneumo_pangenome_k32.r_0.3.S_prophasm.k_17.d_na.M_ones.C_bzip
spneumo_pangenome_k32	0.3	prophasm	17	na	ones	xz	2151218	26093554	2274713	23818841	1605747	1496396	26093554	7586020	6665236	691460	7356696	7895724	spneumo_pangenome_k32.r_0.3.S_prophasm.k_17.d_na.M_ones.C_xz
spneumo_pangenome_k32	0.3	prophasm	17	na	runsapprox	bzip	2151218	26093554	2274713	23818841	1605747	1496396	26093554	7586020	6665236	460356	7125592	7895724	spneumo_pangenome_k32.r_0.3.S_prophasm.k_17.d_na.M_runsapprox.C_bzip
spneumo_pangenome_k32	0.3	prophasm	17	na	runsapprox	xz	2151218	26093554	2274713	23818841	1605747	1496396	26093554	7586020	6665236	691460	7356696	7895724	spneumo_pangenome_k32.r_0.3.S_prophasm.k_17.d_na.M_runsapprox.C_xz
spneumo_pangenome_k32	0.4	prophasm	17	na	default	bzip	2868290	30248386	2868290	27380096	1711256	1711256	30248386	8781604	7706828	430009	8136837	9052400	spneumo_pangenome_k32.r_0.4.S_prophasm.k_17.d_na.M_default.C_bzip
spneumo_pangenome_k32	0.4	prophasm	17	na	default	xz	2868290	30248386	2868290	27380096	1711256	1711256	30248386	8781604	7706828	650592	8357420	9052400	spneumo_pangenome_k32.r_0.4.S_prophasm.k_17.d_na.M_default.C_xz
spneumo_pangenome_k32	0.4	prophasm	17	na	ones	bzip	2868290	30248386	3059507	27188879	1872328	1711256	30248386	8781604	7706828	665296	8372124	9242668	spneumo_pangenome_k32.r_0.4.S_prophasm.k_17.d_na.M_ones.C_bzip
spneumo_pangenome_k32	0.4	prophasm	17	na	ones	xz	2868290	30248386	3059507	27188879	1872328	1711256	30248386	8781604	7706828	938412	8645240	9242668	spneumo_pangenome_k32.r_0.4.S_prophasm.k_17.d_na.M_ones.C_xz
spneumo_pangenome_k32	0.4	prophasm	17	na	runsapprox	bzip	2868290	30248386	3059507	27188879	1872328	1711256	30248386	8781604	7706828	665296	8372124	9242668	spneumo_pangenome_k32.r_0.4.S_prophasm.k_17.d_na.M_runsapprox.C_bzip
spneumo_pangenome_k32	0.4	prophasm	17	na	runsapprox	xz	2868290	30248386	3059507	27188879	1872328	1711256	30248386	8781604	7706828	938412	8645240	9242668	spneumo_pangenome_k32.r_0.4.S_prophasm.k_17.d_na.M_runsapprox.C_xz
spneumo_pangenome_k32	0.5	prophasm	17	na	default	bzip	3585363	32199267	3585363	28613904	1788369	1788369	32199267	9329340	8188376	542272	8730648	9721928	spneumo_pangenome_k32.r_0.5.S_prophasm.k_17.d_na.M_default.C_bzip
spneumo_pangenome_k32	0.5	prophasm	17	na	default	xz	3585363	32199267	3585363	28613904	1788369	1788369	32199267	9329340	8188376	786940	8975316	9721928	spneumo_pangenome_k32.r_0.5.S_prophasm.k_17.d_na.M_default.C_xz
spneumo_pangenome_k32	0.5	prophasm	17	na	ones	bzip	3585363	32199267	3838932	28360335	1989970	1788369	32199267	9329340	8188376	840978	9029354	9950048	spneumo_pangenome_k32.r_0.5.S_prophasm.k_17.d_na.M_ones.C_bzip
spneumo_pangenome_k32	0.5	prophasm	17	na	ones	xz	3585363	32199267	3838932	28360335	1989970	1788369	32199267	9329340	8188376	1122896	9311272	9950048	spneumo_pangenome_k32.r_0.5.S_prophasm.k_17.d_na.M_ones.C_xz
spneumo_pangenome_k32	0.5	prophasm	17	na	runsapprox	bzip	3585363	32199267	3838932	28360335	1989970	1788369	32199267	9329340	8188376	840978	9029354	9950048	spneumo_pangenome_k32.r_0.5.S_prophasm.k_17.d_na.M_runsapprox.C_bzip
spneumo_pangenome_k32	0.5	prophasm	17	na	runsapprox	xz	3585363	32199267	3838932	28360335	1989970	1788369	32199267	9329340	8188376	1122896	9311272	9950048	spneumo_pangenome_k32.r_0.5.S_prophasm.k_17.d_na.M_runsapprox.C_xz
spneumo_pangenome_k32	0.6	prophasm	17	na	default	bzip	4302436	31994772	4302436	27692336	1730771	1730771	31994772	9245212	8116940	617699	8734639	9678096	spneumo_pangenome_k32.r_0.6.S_prophasm.k_17.d_na.M_default.C_bzip
spneumo_pangenome_k32	0.6	prophasm	17	na	default	xz	4302436	31994772	4302436	27692336	1730771	1730771	31994772	9245212	8116940	864796	8981736	9678096	spneumo_pangenome_k32.r_0.6.S_prophasm.k_17.d_na.M_default.C_xz
spneumo_pangenome_k32	0.6	prophasm	17	na	ones	bzip	4302436	31994772	4603614	27391158	1954495	1730771	31994772	9245212	8116940	957094	9074034	9993972	spneumo_pangenome_k32.r_0.6.S_prophasm.k_17.d_na.M_ones.C_bzip
spneumo_pangenome_k32	0.6	prophasm	17	na	ones	xz	4302436	31994772	4603614	27391158	1954495	1730771	31994772	9245212	8116940	1225132	9342072	9993972	spneumo_pangenome_k32.r_0.6.S_prophasm.k_17.d_na.M_ones.C_xz
spneumo_pangenome_k32	0.6	prophasm	17	na	runsapprox	bzip	4302436	31994772	4603614	27391158	1954495	1730771	31994772	9245212	8116940	957094	9074034	9993972	spneumo_pangenome_k32.r_0.6.S_prophasm.k_17.d_na.M_runsapprox.C_bzip
spneumo_pangenome_k32	0.6	prophasm	17	na	runsapprox	xz	4302436	31994772	4603614	27391158	1954495	1730771	31994772	9245212	8116940	1225132	9342072	9993972	spneumo_pangenome_k32.r_0.6.S_prophasm.k_17.d_na.M_runsapprox.C_xz
spneumo_pangenome_k32	0.7	prophasm	17	na	default	bzip	5019508	29644036	5019508	24624528	1539033	1539033	29644036	8518576	7506332	636720	8143052	9066140	spneumo_pangenome_k32.r_0.7.S_prophasm.k_17.d_na.M_default.C_bzip
spneumo_pangenome_k32	0.7	prophasm	17	na	default	xz	5019508	29644036	5019508	24624528	1539033	1539033	29644036	8518576	7506332	873704	8380036	9066140	spneumo_pangenome_k32.r_0.7.S_prophasm.k_17.d_na.M_default.C_xz
spneumo_pangenome_k32	0.7	prophasm	17	na	ones	bzip	5019508	29644036	5342059	24301977	1758177	1539033	29644036	8518576	7506332	983296	8489628	9376928	spneumo_pangenome_k32.r_0.7.S_prophasm.k_17.d_na.M_ones.C_bzip
spneumo_pangenome_k32	0.7	prophasm	17	na	ones	xz	5019508	29644036	5342059	24301977	1758177	1539033	29644036	8518576	7506332	1226784	8733116	9376928	spneumo_pangenome_k32.r_0.7.S_prophasm.k_17.d_na.M_ones.C_xz
spneumo_pangenome_k32	0.7	prophasm	17	na	runsapprox	bzip	5019508	29644036	5342059	24301977	1758177	1539033	29644036	8518576	7506332	983296	8489628	9376928	spneumo_pangenome_k32.r_0.7.S_prophasm.k_17.d_na.M_runsapprox.C_bzip
spneumo_pangenome_k32	0.7	prophasm	17	na	runsapprox	xz	5019508	29644036	5342059	24301977	1758177	1539033	29644036	8518576	7506332	1226784	8733116	9376928	spneumo_pangenome_k32.r_0.7.S_prophasm.k_17.d_na.M_runsapprox.C_xz
spneumo_pangenome_k32	0.8	prophasm	17	na	default	bzip	5736581	25194693	5736581	19458112	1216132	1216132	25194693	7184212	6361144	581529	6942673	7936536	spneumo_pangenome_k32.r_0.8.S_prophasm.k_17.d_na.M_default.C_bzip
spneumo_pangenome_k32	0.8	prophasm	17	na	default	xz	5736581	25194693	5736581	19458112	1216132	1216132	25194693	7184212	6361144	797340	7158484	7936536	spneumo_pangenome_k32.r_0.8.S_prophasm.k_17.d_na.M_default.C_xz
spneumo_pangenome_k32	0.8	prophasm	17	na	ones	bzip	5736581	25194693	6048097	19146596	1400648	1216132	25194693	7184212	6361144	896391	7257535	8133228	spneumo_pangenome_k32.r_0.8.S_prophasm.k_17.d_na.M_ones.C_bzip
spneumo_pangenome_k32	0.8	prophasm	17	na	ones	xz	5736581	25194693	6048097	19146596	1400648	1216132	25194693	7184212	6361144	1106484	7467628	8133228	spneumo_pangenome_k32.r_0.8.S_prophasm.k_17.d_na.M_ones.C_xz
spneumo_pangenome_k32	0.8	prophasm	17	na	runsapprox	bzip	5736581	25194693	6048097	19146596	1400648	1216132	25194693	7184212	6361144	896391	7257535	8133228	spneumo_pangenome_k32.r_0.8.S_prophasm.k_17.d_na.M_runsapprox.C_bzip
spneumo_pangenome_k32	0.8	prophasm	17	na	runsapprox	xz	5736581	25194693	6048097	19146596	1400648	1216132	25194693	7184212	6361144	1106484	7467628	8133228	spneumo_pangenome_k32.r_0.8.S_prophasm.k_17.d_na.M_runsapprox.C_xz
spneumo_pangenome_k32	0.9	prophasm	17	na	default	bzip	6453654	18657254	6453654	12203600	762725	762725	18657254	5214084	4668696	433680	5102376	5840880	spneumo_pangenome_k32.r_0.9.S_prophasm.k_17.d_na.M_default.C_bzip
spneumo_pangenome_k32	0.9	prophasm	17	na	default	xz	6453654	18657254	6453654	12203600	762725	762725	18657254	5214084	4668696	610848	5279544	5840880	spneumo_pangenome_k32.r_0.9.S_prophasm.k_17.d_na.M_default.C_xz
spneumo_pangenome_k32	0.9	prophasm	17	na	ones	bzip	6453654	18657254	6710688	11946566	877334	762725	18657254	5214084	4668696	666177	5334873	5977368	spneumo_pangenome_k32.r_0.9.S_prophasm.k_17.d_na.M_ones.C_bzip
spneumo_pangenome_k32	0.9	prophasm	17	na	ones	xz	6453654	18657254	6710688	11946566	877334	762725	18657254	5214084	4668696	832872	5501568	5977368	spneumo_pangenome_k32.r_0.9.S_prophasm.k_17.d_na.M_ones.C_xz
spneumo_pangenome_k32	0.9	prophasm	17	na	runsapprox	bzip	6453654	18657254	6710688	11946566	877334	762725	18657254	5214084	4668696	666177	5334873	5977368	spneumo_pangenome_k32.r_0.9.S_prophasm.k_17.d_na.M_runsapprox.C_bzip
spneumo_pangenome_k32	0.9	prophasm	17	na	runsapprox	xz	6453654	18657254	6710688	11946566	877334	762725	18657254	5214084	4668696	832872	5501568	5977368	spneumo_pangenome_k32.r_0.9.S_prophasm.k_17.d_na.M_runsapprox.C_xz
spneumo_pangenome_k32	1.0	prophasm	17	na	default	bzip	7170727	10067815	7170727	2897088	181068	181068	10067815	2437200	2321376	135960	2457336	2798440	spneumo_pangenome_k32.r_1.0.S_prophasm.k_17.d_na.M_default.C_bzip
spneumo_pangenome_k32	1.0	prophasm	17	na	default	xz	7170727	10067815	7170727	2897088	181068	181068	10067815	2437200	2321376	211596	2532972	2798440	spneumo_pangenome_k32.r_1.0.S_prophasm.k_17.d_na.M_default.C_xz
spneumo_pangenome_k32	1.0	prophasm	17	na	ones	bzip	7170727	10067815	7323157	2744658	187964	181068	10067815	2437200	2321376	202881	2524257	2814552	spneumo_pangenome_k32.r_1.0.S_prophasm.k_17.d_na.M_ones.C_bzip
spneumo_pangenome_k32	1.0	prophasm	17	na	ones	xz	7170727	10067815	7323157	2744658	187964	181068	10067815	2437200	2321376	277956	2599332	2814552	spneumo_pangenome_k32.r_1.0.S_prophasm.k_17.d_na.M_ones.C_xz
spneumo_pangenome_k32	1.0	prophasm	17	na	runsapprox	bzip	7170727	10067815	7323157	2744658	187964	181068	10067815	2437200	2321376	202881	2524257	2814552	spneumo_pangenome_k32.r_1.0.S_prophasm.k_17.d_na.M_runsapprox.C_bzip
spneumo_pangenome_k32	1.0	prophasm	17	na	runsapprox	xz	7170727	10067815	7323157	2744658	187964	181068	10067815	2437200	2321376	277956	2599332	2814552	spneumo_pangenome_k32.r_1.0.S_prophasm.k_17.d_na.M_runsapprox.C_xz
spneumo_pangenome_k32	0.000000001	eulertigs	19	na	default	bzip	1	19	1	18	1	1	19	84	84	41	125	84	spneumo_pangenome_k32.r_0.000000001.S_eulertigs.k_19.d_na.M_default.C_bzip
spneumo_pangenome_k32	0.000000001	eulertigs	19	na	default	xz	1	19	1	18	1	1	19	84	84	76	160	84	spneumo_pangenome_k32.r_0.000000001.S_eulertigs.k_19.d_na.M_default.C_xz
spneumo_pangenome_k32	0.000000001	eulertigs	19	na	ones	bzip	1	19	1	18	1	1	19	84	84	41	125	84	spneumo_pangenome_k32.r_0.000000001.S_eulertigs.k_19.d_na.M_ones.C_bzip
spneumo_pangenome_k32	0.000000001	eulertigs	19	na	ones	xz	1	19	1	18	1	1	19	84	84	76	160	84	spneumo_pangenome_k32.r_0.000000001.S_eulertigs.k_19.d_na.M_ones.C_xz
spneumo_pangenome_k32	0.000000001	eulertigs	19	na	runsapprox	bzip	1	19	1	18	1	1	19	84	84	41	125	84	spneumo_pangenome_k32.r_0.000000001.S_eulertigs.k_19.d_na.M_runsapprox.C_bzip
spneumo_pangenome_k32	0.000000001	eulertigs	19	na	runsapprox	xz	1	19	1	18	1	1	19	84	84	76	160	84	spneumo_pangenome_k32.r_0.000000001.S_eulertigs.k_19.d_na.M_runsapprox.C_xz
spneumo_pangenome_k32	0.0001	eulertigs	19	na	default	bzip	755	14327	755	13572	754	754	14327	4424	4172	47	4219	4408	spneumo_pangenome_k32.r_0.0001.S_eulertigs.k_19.d_na.M_default.C_bzip
spneumo_pangenome_k32	0.0001	eulertigs	19	na	default	xz	755	14327	755	13572	754	754	14327	4424	4172	132	4304	4408	spneumo_pangenome_k32.r_0.0001.S_eulertigs.k_19.d_na.M_default.C_xz
spneumo_pangenome_k32	0.0001	eulertigs	19	na	ones	bzip	755	14327	756	13571	755	754	14327	4424	4172	51	4223	4408	spneumo_pangenome_k32.r_0.0001.S_eulertigs.k_19.d_na.M_ones.C_bzip
spneumo_pangenome_k32	0.0001	eulertigs	19	na	ones	xz	755	14327	756	13571	755	754	14327	4424	4172	140	4312	4408	spneumo_pangenome_k32.r_0.0001.S_eulertigs.k_19.d_na.M_ones.C_xz
spneumo_pangenome_k32	0.0001	eulertigs	19	na	runsapprox	bzip	755	14327	756	13571	755	754	14327	4424	4172	51	4223	4408	spneumo_pangenome_k32.r_0.0001.S_eulertigs.k_19.d_na.M_runsapprox.C_bzip
spneumo_pangenome_k32	0.0001	eulertigs	19	na	runsapprox	xz	755	14327	756	13571	755	754	14327	4424	4172	140	4312	4408	spneumo_pangenome_k32.r_0.0001.S_eulertigs.k_19.d_na.M_runsapprox.C_xz
spneumo_pangenome_k32	0.001	eulertigs	19	na	default	bzip	7551	143307	7551	135756	7542	7542	143307	40048	37784	67	37851	40412	spneumo_pangenome_k32.r_0.001.S_eulertigs.k_19.d_na.M_default.C_bzip
spneumo_pangenome_k32	0.001	eulertigs	19	na	default	xz	7551	143307	7551	135756	7542	7542	143307	40048	37784	204	37988	40412	spneumo_pangenome_k32.r_0.001.S_eulertigs.k_19.d_na.M_default.C_xz
spneumo_pangenome_k32	0.001	eulertigs	19	na	ones	bzip	7551	143307	7551	135756	7542	7542	143307	40048	37784	67	37851	40412	spneumo_pangenome_k32.r_0.001.S_eulertigs.k_19.d_na.M_ones.C_bzip
spneumo_pangenome_k32	0.001	eulertigs	19	na	ones	xz	7551	143307	7551	135756	7542	7542	143307	40048	37784	204	37988	40412	spneumo_pangenome_k32.r_0.001.S_eulertigs.k_19.d_na.M_ones.C_xz
spneumo_pangenome_k32	0.001	eulertigs	19	na	runsapprox	bzip	7551	143307	7551	135756	7542	7542	143307	40048	37784	67	37851	40412	spneumo_pangenome_k32.r_0.001.S_eulertigs.k_19.d_na.M_runsapprox.C_bzip
spneumo_pangenome_k32	0.001	eulertigs	19	na	runsapprox	xz	7551	143307	7551	135756	7542	7542	143307	40048	37784	204	37988	40412	spneumo_pangenome_k32.r_0.001.S_eulertigs.k_19.d_na.M_runsapprox.C_xz
spneumo_pangenome_k32	0.01	eulertigs	19	na	default	bzip	75514	1419916	75514	1344402	74689	74689	1419916	389916	359952	1462	361414	396852	spneumo_pangenome_k32.r_0.01.S_eulertigs.k_19.d_na.M_default.C_bzip
spneumo_pangenome_k32	0.01	eulertigs	19	na	default	xz	75514	1419916	75514	1344402	74689	74689	1419916	389916	359952	2676	362628	396852	spneumo_pangenome_k32.r_0.01.S_eulertigs.k_19.d_na.M_default.C_xz
spneumo_pangenome_k32	0.01	eulertigs	19	na	ones	bzip	75514	1419916	75684	1344232	74858	74689	1419916	389916	359952	1810	361762	396892	spneumo_pangenome_k32.r_0.01.S_eulertigs.k_19.d_na.M_ones.C_bzip
spneumo_pangenome_k32	0.01	eulertigs	19	na	ones	xz	75514	1419916	75684	1344232	74858	74689	1419916	389916	359952	3468	363420	396892	spneumo_pangenome_k32.r_0.01.S_eulertigs.k_19.d_na.M_ones.C_xz
spneumo_pangenome_k32	0.01	eulertigs	19	na	runsapprox	bzip	75514	1419916	75684	1344232	74858	74689	1419916	389916	359952	1810	361762	396892	spneumo_pangenome_k32.r_0.01.S_eulertigs.k_19.d_na.M_runsapprox.C_bzip
spneumo_pangenome_k32	0.01	eulertigs	19	na	runsapprox	xz	75514	1419916	75684	1344232	74858	74689	1419916	389916	359952	3468	363420	396892	spneumo_pangenome_k32.r_0.01.S_eulertigs.k_19.d_na.M_runsapprox.C_xz
spneumo_pangenome_k32	0.05	eulertigs	19	na	default	bzip	377570	6826736	377570	6449166	358287	358287	6826736	1938380	1732380	22834	1755214	1979816	spneumo_pangenome_k32.r_0.05.S_eulertigs.k_19.d_na.M_default.C_bzip
spneumo_pangenome_k32	0.05	eulertigs	19	na	default	xz	377570	6826736	377570	6449166	358287	358287	6826736	1938380	1732380	38140	1770520	1979816	spneumo_pangenome_k32.r_0.05.S_eulertigs.k_19.d_na.M_default.C_xz
spneumo_pangenome_k32	0.05	eulertigs	19	na	ones	bzip	377570	6826736	381327	6445409	361973	358287	6826736	1938380	1732380	29053	1761433	1983540	spneumo_pangenome_k32.r_0.05.S_eulertigs.k_19.d_na.M_ones.C_bzip
spneumo_pangenome_k32	0.05	eulertigs	19	na	ones	xz	377570	6826736	381327	6445409	361973	358287	6826736	1938380	1732380	50876	1783256	1983540	spneumo_pangenome_k32.r_0.05.S_eulertigs.k_19.d_na.M_ones.C_xz
spneumo_pangenome_k32	0.05	eulertigs	19	na	runsapprox	bzip	377570	6826736	381327	6445409	361973	358287	6826736	1938380	1732380	29053	1761433	1983540	spneumo_pangenome_k32.r_0.05.S_eulertigs.k_19.d_na.M_runsapprox.C_bzip
spneumo_pangenome_k32	0.05	eulertigs	19	na	runsapprox	xz	377570	6826736	381327	6445409	361973	358287	6826736	1938380	1732380	50876	1783256	1983540	spneumo_pangenome_k32.r_0.05.S_eulertigs.k_19.d_na.M_runsapprox.C_xz
spneumo_pangenome_k32	0.1	eulertigs	19	na	default	bzip	755141	12959843	755141	12204702	678039	678039	12959843	3665820	3255800	68988	3324788	3769420	spneumo_pangenome_k32.r_0.1.S_eulertigs.k_19.d_na.M_default.C_bzip
spneumo_pangenome_k32	0.1	eulertigs	19	na	default	xz	755141	12959843	755141	12204702	678039	678039	12959843	3665820	3255800	113152	3368952	3769420	spneumo_pangenome_k32.r_0.1.S_eulertigs.k_19.d_na.M_default.C_xz
spneumo_pangenome_k32	0.1	eulertigs	19	na	ones	bzip	755141	12959843	769457	12190386	691842	678039	12959843	3665820	3255800	90022	3345822	3779852	spneumo_pangenome_k32.r_0.1.S_eulertigs.k_19.d_na.M_ones.C_bzip
spneumo_pangenome_k32	0.1	eulertigs	19	na	ones	xz	755141	12959843	769457	12190386	691842	678039	12959843	3665820	3255800	153656	3409456	3779852	spneumo_pangenome_k32.r_0.1.S_eulertigs.k_19.d_na.M_ones.C_xz
spneumo_pangenome_k32	0.1	eulertigs	19	na	runsapprox	bzip	755141	12959843	769457	12190386	691842	678039	12959843	3665820	3255800	90022	3345822	3779852	spneumo_pangenome_k32.r_0.1.S_eulertigs.k_19.d_na.M_runsapprox.C_bzip
spneumo_pangenome_k32	0.1	eulertigs	19	na	runsapprox	xz	755141	12959843	769457	12190386	691842	678039	12959843	3665820	3255800	153656	3409456	3779852	spneumo_pangenome_k32.r_0.1.S_eulertigs.k_19.d_na.M_runsapprox.C_xz
spneumo_pangenome_k32	0.2	eulertigs	19	na	default	bzip	1510282	23165884	1510282	21655602	1203089	1203089	23165884	6513464	5772220	193201	5965421	6670984	spneumo_pangenome_k32.r_0.2.S_eulertigs.k_19.d_na.M_default.C_bzip
spneumo_pangenome_k32	0.2	eulertigs	19	na	default	xz	1510282	23165884	1510282	21655602	1203089	1203089	23165884	6513464	5772220	315672	6087892	6670984	spneumo_pangenome_k32.r_0.2.S_eulertigs.k_19.d_na.M_default.C_xz
spneumo_pangenome_k32	0.2	eulertigs	19	na	ones	bzip	1510282	23165884	1562144	21603740	1251119	1203089	23165884	6513464	5772220	260168	6032388	6721212	spneumo_pangenome_k32.r_0.2.S_eulertigs.k_19.d_na.M_ones.C_bzip
spneumo_pangenome_k32	0.2	eulertigs	19	na	ones	xz	1510282	23165884	1562144	21603740	1251119	1203089	23165884	6513464	5772220	426176	6198396	6721212	spneumo_pangenome_k32.r_0.2.S_eulertigs.k_19.d_na.M_ones.C_xz
spneumo_pangenome_k32	0.2	eulertigs	19	na	runsapprox	bzip	1510282	23165884	1562144	21603740	1251119	1203089	23165884	6513464	5772220	260168	6032388	6721212	spneumo_pangenome_k32.r_0.2.S_eulertigs.k_19.d_na.M_runsapprox.C_bzip
spneumo_pangenome_k32	0.2	eulertigs	19	na	runsapprox	xz	1510282	23165884	1562144	21603740	1251119	1203089	23165884	6513464	5772220	426176	6198396	6721212	spneumo_pangenome_k32.r_0.2.S_eulertigs.k_19.d_na.M_runsapprox.C_xz
spneumo_pangenome_k32	0.3	eulertigs	19	na	default	bzip	2265423	30666399	2265423	28400976	1577832	1577832	30666399	8613720	7609100	338603	7947703	8914200	spneumo_pangenome_k32.r_0.3.S_eulertigs.k_19.d_na.M_default.C_bzip
spneumo_pangenome_k32	0.3	eulertigs	19	na	default	xz	2265423	30666399	2265423	28400976	1577832	1577832	30666399	8613720	7609100	545408	8154508	8914200	spneumo_pangenome_k32.r_0.3.S_eulertigs.k_19.d_na.M_default.C_xz
spneumo_pangenome_k32	0.3	eulertigs	19	na	ones	bzip	2265423	30666399	2367901	28298498	1668776	1577832	30666399	8613720	7609100	461862	8070962	8975956	spneumo_pangenome_k32.r_0.3.S_eulertigs.k_19.d_na.M_ones.C_bzip
spneumo_pangenome_k32	0.3	eulertigs	19	na	ones	xz	2265423	30666399	2367901	28298498	1668776	1577832	30666399	8613720	7609100	719768	8328868	8975956	spneumo_pangenome_k32.r_0.3.S_eulertigs.k_19.d_na.M_ones.C_xz
spneumo_pangenome_k32	0.3	eulertigs	19	na	runsapprox	bzip	2265423	30666399	2367901	28298498	1668776	1577832	30666399	8613720	7609100	461862	8070962	8975956	spneumo_pangenome_k32.r_0.3.S_eulertigs.k_19.d_na.M_runsapprox.C_bzip
spneumo_pangenome_k32	0.3	eulertigs	19	na	runsapprox	xz	2265423	30666399	2367901	28298498	1668776	1577832	30666399	8613720	7609100	719768	8328868	8975956	spneumo_pangenome_k32.r_0.3.S_eulertigs.k_19.d_na.M_runsapprox.C_xz
spneumo_pangenome_k32	0.4	eulertigs	19	na	default	bzip	3020564	35500070	3020564	32479506	1804417	1804417	35500070	9960648	8792856	485900	9278756	10415784	spneumo_pangenome_k32.r_0.4.S_eulertigs.k_19.d_na.M_default.C_bzip
spneumo_pangenome_k32	0.4	eulertigs	19	na	default	xz	3020564	35500070	3020564	32479506	1804417	1804417	35500070	9960648	8792856	759308	9552164	10415784	spneumo_pangenome_k32.r_0.4.S_eulertigs.k_19.d_na.M_default.C_xz
spneumo_pangenome_k32	0.4	eulertigs	19	na	ones	bzip	3020564	35500070	3179969	32320101	1939086	1804417	35500070	9960648	8792856	669083	9461939	10535768	spneumo_pangenome_k32.r_0.4.S_eulertigs.k_19.d_na.M_ones.C_bzip
spneumo_pangenome_k32	0.4	eulertigs	19	na	ones	xz	3020564	35500070	3179969	32320101	1939086	1804417	35500070	9960648	8792856	987872	9780728	10535768	spneumo_pangenome_k32.r_0.4.S_eulertigs.k_19.d_na.M_ones.C_xz
spneumo_pangenome_k32	0.4	eulertigs	19	na	runsapprox	bzip	3020564	35500070	3179969	32320101	1939086	1804417	35500070	9960648	8792856	669083	9461939	10535768	spneumo_pangenome_k32.r_0.4.S_eulertigs.k_19.d_na.M_runsapprox.C_bzip
spneumo_pangenome_k32	0.4	eulertigs	19	na	runsapprox	xz	3020564	35500070	3179969	32320101	1939086	1804417	35500070	9960648	8792856	987872	9780728	10535768	spneumo_pangenome_k32.r_0.4.S_eulertigs.k_19.d_na.M_runsapprox.C_xz
spneumo_pangenome_k32	0.5	eulertigs	19	na	default	bzip	3775706	37737170	3775706	33961464	1886748	1886748	37737170	10528744	9305012	617144	9922156	11180300	spneumo_pangenome_k32.r_0.5.S_eulertigs.k_19.d_na.M_default.C_bzip
spneumo_pangenome_k32	0.5	eulertigs	19	na	default	xz	3775706	37737170	3775706	33961464	1886748	1886748	37737170	10528744	9305012	928916	10233928	11180300	spneumo_pangenome_k32.r_0.5.S_eulertigs.k_19.d_na.M_default.C_xz
spneumo_pangenome_k32	0.5	eulertigs	19	na	ones	bzip	3775706	37737170	3986656	33750514	2055967	1886748	37737170	10528744	9305012	850947	10155959	11320972	spneumo_pangenome_k32.r_0.5.S_eulertigs.k_19.d_na.M_ones.C_bzip
spneumo_pangenome_k32	0.5	eulertigs	19	na	ones	xz	3775706	37737170	3986656	33750514	2055967	1886748	37737170	10528744	9305012	1191948	10496960	11320972	spneumo_pangenome_k32.r_0.5.S_eulertigs.k_19.d_na.M_ones.C_xz
spneumo_pangenome_k32	0.5	eulertigs	19	na	runsapprox	bzip	3775706	37737170	3986656	33750514	2055967	1886748	37737170	10528744	9305012	850947	10155959	11320972	spneumo_pangenome_k32.r_0.5.S_eulertigs.k_19.d_na.M_runsapprox.C_bzip
spneumo_pangenome_k32	0.5	eulertigs	19	na	runsapprox	xz	3775706	37737170	3986656	33750514	2055967	1886748	37737170	10528744	9305012	1191948	10496960	11320972	spneumo_pangenome_k32.r_0.5.S_eulertigs.k_19.d_na.M_runsapprox.C_xz
spneumo_pangenome_k32	0.6	eulertigs	19	na	default	bzip	4530847	37340923	4530847	32810076	1822782	1822782	37340923	10388192	9204848	710198	9915046	11172248	spneumo_pangenome_k32.r_0.6.S_eulertigs.k_19.d_na.M_default.C_bzip
spneumo_pangenome_k32	0.6	eulertigs	19	na	default	xz	4530847	37340923	4530847	32810076	1822782	1822782	37340923	10388192	9204848	1030536	10235384	11172248	spneumo_pangenome_k32.r_0.6.S_eulertigs.k_19.d_na.M_default.C_xz
spneumo_pangenome_k32	0.6	eulertigs	19	na	ones	bzip	4530847	37340923	4781095	32559828	2010510	1822782	37340923	10388192	9204848	977303	10182151	11356380	spneumo_pangenome_k32.r_0.6.S_eulertigs.k_19.d_na.M_ones.C_bzip
spneumo_pangenome_k32	0.6	eulertigs	19	na	ones	xz	4530847	37340923	4781095	32559828	2010510	1822782	37340923	10388192	9204848	1308884	10513732	11356380	spneumo_pangenome_k32.r_0.6.S_eulertigs.k_19.d_na.M_ones.C_xz
spneumo_pangenome_k32	0.6	eulertigs	19	na	runsapprox	bzip	4530847	37340923	4781095	32559828	2010510	1822782	37340923	10388192	9204848	977303	10182151	11356380	spneumo_pangenome_k32.r_0.6.S_eulertigs.k_19.d_na.M_runsapprox.C_bzip
spneumo_pangenome_k32	0.6	eulertigs	19	na	runsapprox	xz	4530847	37340923	4781095	32559828	2010510	1822782	37340923	10388192	9204848	1308884	10513732	11356380	spneumo_pangenome_k32.r_0.6.S_eulertigs.k_19.d_na.M_runsapprox.C_xz
spneumo_pangenome_k32	0.7	eulertigs	19	na	default	bzip	5285988	34413534	5285988	29127546	1618197	1618197	34413534	9520900	8458672	739391	9198063	10593504	spneumo_pangenome_k32.r_0.7.S_eulertigs.k_19.d_na.M_default.C_bzip
spneumo_pangenome_k32	0.7	eulertigs	19	na	default	xz	5285988	34413534	5285988	29127546	1618197	1618197	34413534	9520900	8458672	1048516	9507188	10593504	spneumo_pangenome_k32.r_0.7.S_eulertigs.k_19.d_na.M_default.C_xz
spneumo_pangenome_k32	0.7	eulertigs	19	na	ones	bzip	5285988	34413534	5557389	28856145	1803438	1618197	34413534	9520900	8458672	1016821	9475493	10618284	spneumo_pangenome_k32.r_0.7.S_eulertigs.k_19.d_na.M_ones.C_bzip
spneumo_pangenome_k32	0.7	eulertigs	19	na	ones	xz	5285988	34413534	5557389	28856145	1803438	1618197	34413534	9520900	8458672	1317088	9775760	10618284	spneumo_pangenome_k32.r_0.7.S_eulertigs.k_19.d_na.M_ones.C_xz
spneumo_pangenome_k32	0.7	eulertigs	19	na	runsapprox	bzip	5285988	34413534	5557389	28856145	1803438	1618197	34413534	9520900	8458672	1016821	9475493	10618284	spneumo_pangenome_k32.r_0.7.S_eulertigs.k_19.d_na.M_runsapprox.C_bzip
spneumo_pangenome_k32	0.7	eulertigs	19	na	runsapprox	xz	5285988	34413534	5557389	28856145	1803438	1618197	34413534	9520900	8458672	1317088	9775760	10618284	spneumo_pangenome_k32.r_0.7.S_eulertigs.k_19.d_na.M_runsapprox.C_xz
spneumo_pangenome_k32	0.8	eulertigs	19	na	default	bzip	6041129	28949153	6041129	22908024	1272668	1272668	28949153	7945116	7081732	684297	7766029	8892552	spneumo_pangenome_k32.r_0.8.S_eulertigs.k_19.d_na.M_default.C_bzip
spneumo_pangenome_k32	0.8	eulertigs	19	na	default	xz	6041129	28949153	6041129	22908024	1272668	1272668	28949153	7945116	7081732	952048	8033780	8892552	spneumo_pangenome_k32.r_0.8.S_eulertigs.k_19.d_na.M_default.C_xz
spneumo_pangenome_k32	0.8	eulertigs	19	na	ones	bzip	6041129	28949153	6302397	22646756	1427558	1272668	28949153	7945116	7081732	933866	8015598	9101164	spneumo_pangenome_k32.r_0.8.S_eulertigs.k_19.d_na.M_ones.C_bzip
spneumo_pangenome_k32	0.8	eulertigs	19	na	ones	xz	6041129	28949153	6302397	22646756	1427558	1272668	28949153	7945116	7081732	1184924	8266656	9101164	spneumo_pangenome_k32.r_0.8.S_eulertigs.k_19.d_na.M_ones.C_xz
spneumo_pangenome_k32	0.8	eulertigs	19	na	runsapprox	bzip	6041129	28949153	6302397	22646756	1427558	1272668	28949153	7945116	7081732	933866	8015598	9101164	spneumo_pangenome_k32.r_0.8.S_eulertigs.k_19.d_na.M_runsapprox.C_bzip
spneumo_pangenome_k32	0.8	eulertigs	19	na	runsapprox	xz	6041129	28949153	6302397	22646756	1427558	1272668	28949153	7945116	7081732	1184924	8266656	9101164	spneumo_pangenome_k32.r_0.8.S_eulertigs.k_19.d_na.M_runsapprox.C_xz
spneumo_pangenome_k32	0.9	eulertigs	19	na	default	bzip	6796270	20999404	6796270	14203134	789063	789063	20999404	5662568	5088672	512952	5601624	6489208	spneumo_pangenome_k32.r_0.9.S_eulertigs.k_19.d_na.M_default.C_bzip
spneumo_pangenome_k32	0.9	eulertigs	19	na	default	xz	6796270	20999404	6796270	14203134	789063	789063	20999404	5662568	5088672	703020	5791692	6489208	spneumo_pangenome_k32.r_0.9.S_eulertigs.k_19.d_na.M_default.C_xz
spneumo_pangenome_k32	0.9	eulertigs	19	na	ones	bzip	6796270	20999404	7012533	13986871	883798	789063	20999404	5662568	5088672	696781	5785453	6604320	spneumo_pangenome_k32.r_0.9.S_eulertigs.k_19.d_na.M_ones.C_bzip
spneumo_pangenome_k32	0.9	eulertigs	19	na	ones	xz	6796270	20999404	7012533	13986871	883798	789063	20999404	5662568	5088672	878700	5967372	6604320	spneumo_pangenome_k32.r_0.9.S_eulertigs.k_19.d_na.M_ones.C_xz
spneumo_pangenome_k32	0.9	eulertigs	19	na	runsapprox	bzip	6796270	20999404	7012533	13986871	883798	789063	20999404	5662568	5088672	696781	5785453	6604320	spneumo_pangenome_k32.r_0.9.S_eulertigs.k_19.d_na.M_runsapprox.C_bzip
spneumo_pangenome_k32	0.9	eulertigs	19	na	runsapprox	xz	6796270	20999404	7012533	13986871	883798	789063	20999404	5662568	5088672	878700	5967372	6604320	spneumo_pangenome_k32.r_0.9.S_eulertigs.k_19.d_na.M_runsapprox.C_xz
spneumo_pangenome_k32	1.0	eulertigs	19	na	default	bzip	7551412	10579300	7551412	3027888	168216	168216	10579300	2595396	2436464	134738	2571202	2938104	spneumo_pangenome_k32.r_1.0.S_eulertigs.k_19.d_na.M_default.C_bzip
spneumo_pangenome_k32	1.0	eulertigs	19	na	default	xz	7551412	10579300	7551412	3027888	168216	168216	10579300	2595396	2436464	220964	2657428	2938104	spneumo_pangenome_k32.r_1.0.S_eulertigs.k_19.d_na.M_default.C_xz
spneumo_pangenome_k32	1.0	eulertigs	19	na	ones	bzip	7551412	10579300	7678375	2900925	169034	168216	10579300	2595396	2436464	185276	2621740	2945704	spneumo_pangenome_k32.r_1.0.S_eulertigs.k_19.d_na.M_ones.C_bzip
spneumo_pangenome_k32	1.0	eulertigs	19	na	ones	xz	7551412	10579300	7678375	2900925	169034	168216	10579300	2595396	2436464	270960	2707424	2945704	spneumo_pangenome_k32.r_1.0.S_eulertigs.k_19.d_na.M_ones.C_xz
spneumo_pangenome_k32	1.0	eulertigs	19	na	runsapprox	bzip	7551412	10579300	7678375	2900925	169034	168216	10579300	2595396	2436464	185276	2621740	2945704	spneumo_pangenome_k32.r_1.0.S_eulertigs.k_19.d_na.M_runsapprox.C_bzip
spneumo_pangenome_k32	1.0	eulertigs	19	na	runsapprox	xz	7551412	10579300	7678375	2900925	169034	168216	10579300	2595396	2436464	270960	2707424	2945704	spneumo_pangenome_k32.r_1.0.S_eulertigs.k_19.d_na.M_runsapprox.C_xz
spneumo_pangenome_k32	0.000000001	greedytigs	19	na	default	bzip	1	19	1	18	1	1	19	84	84	41	125	84	spneumo_pangenome_k32.r_0.000000001.S_greedytigs.k_19.d_na.M_default.C_bzip
spneumo_pangenome_k32	0.000000001	greedytigs	19	na	default	xz	1	19	1	18	1	1	19	84	84	76	160	84	spneumo_pangenome_k32.r_0.000000001.S_greedytigs.k_19.d_na.M_default.C_xz
spneumo_pangenome_k32	0.000000001	greedytigs	19	na	ones	bzip	1	19	1	18	1	1	19	84	84	41	125	84	spneumo_pangenome_k32.r_0.000000001.S_greedytigs.k_19.d_na.M_ones.C_bzip
spneumo_pangenome_k32	0.000000001	greedytigs	19	na	ones	xz	1	19	1	18	1	1	19	84	84	76	160	84	spneumo_pangenome_k32.r_0.000000001.S_greedytigs.k_19.d_na.M_ones.C_xz
spneumo_pangenome_k32	0.000000001	greedytigs	19	na	runsapprox	bzip	1	19	1	18	1	1	19	84	84	41	125	84	spneumo_pangenome_k32.r_0.000000001.S_greedytigs.k_19.d_na.M_runsapprox.C_bzip
spneumo_pangenome_k32	0.000000001	greedytigs	19	na	runsapprox	xz	1	19	1	18	1	1	19	84	84	76	160	84	spneumo_pangenome_k32.r_0.000000001.S_greedytigs.k_19.d_na.M_runsapprox.C_xz
spneumo_pangenome_k32	0.0001	greedytigs	19	na	default	bzip	755	14327	755	13572	754	754	14327	4424	4172	47	4219	4408	spneumo_pangenome_k32.r_0.0001.S_greedytigs.k_19.d_na.M_default.C_bzip
spneumo_pangenome_k32	0.0001	greedytigs	19	na	default	xz	755	14327	755	13572	754	754	14327	4424	4172	132	4304	4408	spneumo_pangenome_k32.r_0.0001.S_greedytigs.k_19.d_na.M_default.C_xz
spneumo_pangenome_k32	0.0001	greedytigs	19	na	ones	bzip	755	14327	756	13571	755	754	14327	4424	4172	51	4223	4408	spneumo_pangenome_k32.r_0.0001.S_greedytigs.k_19.d_na.M_ones.C_bzip
spneumo_pangenome_k32	0.0001	greedytigs	19	na	ones	xz	755	14327	756	13571	755	754	14327	4424	4172	140	4312	4408	spneumo_pangenome_k32.r_0.0001.S_greedytigs.k_19.d_na.M_ones.C_xz
spneumo_pangenome_k32	0.0001	greedytigs	19	na	runsapprox	bzip	755	14327	756	13571	755	754	14327	4424	4172	51	4223	4408	spneumo_pangenome_k32.r_0.0001.S_greedytigs.k_19.d_na.M_runsapprox.C_bzip
spneumo_pangenome_k32	0.0001	greedytigs	19	na	runsapprox	xz	755	14327	756	13571	755	754	14327	4424	4172	140	4312	4408	spneumo_pangenome_k32.r_0.0001.S_greedytigs.k_19.d_na.M_runsapprox.C_xz
spneumo_pangenome_k32	0.001	greedytigs	19	na	default	bzip	7551	143307	7551	135756	7542	7542	143307	40048	37784	67	37851	40412	spneumo_pangenome_k32.r_0.001.S_greedytigs.k_19.d_na.M_default.C_bzip
spneumo_pangenome_k32	0.001	greedytigs	19	na	default	xz	7551	143307	7551	135756	7542	7542	143307	40048	37784	204	37988	40412	spneumo_pangenome_k32.r_0.001.S_greedytigs.k_19.d_na.M_default.C_xz
spneumo_pangenome_k32	0.001	greedytigs	19	na	ones	bzip	7551	143307	7551	135756	7542	7542	143307	40048	37784	67	37851	40412	spneumo_pangenome_k32.r_0.001.S_greedytigs.k_19.d_na.M_ones.C_bzip
spneumo_pangenome_k32	0.001	greedytigs	19	na	ones	xz	7551	143307	7551	135756	7542	7542	143307	40048	37784	204	37988	40412	spneumo_pangenome_k32.r_0.001.S_greedytigs.k_19.d_na.M_ones.C_xz
spneumo_pangenome_k32	0.001	greedytigs	19	na	runsapprox	bzip	7551	143307	7551	135756	7542	7542	143307	40048	37784	67	37851	40412	spneumo_pangenome_k32.r_0.001.S_greedytigs.k_19.d_na.M_runsapprox.C_bzip
spneumo_pangenome_k32	0.001	greedytigs	19	na	runsapprox	xz	7551	143307	7551	135756	7542	7542	143307	40048	37784	204	37988	40412	spneumo_pangenome_k32.r_0.001.S_greedytigs.k_19.d_na.M_runsapprox.C_xz
spneumo_pangenome_k32	0.01	greedytigs	19	na	default	bzip	75514	1419916	75514	1344402	74689	74689	1419916	389916	359952	1462	361414	396852	spneumo_pangenome_k32.r_0.01.S_greedytigs.k_19.d_na.M_default.C_bzip
spneumo_pangenome_k32	0.01	greedytigs	19	na	default	xz	75514	1419916	75514	1344402	74689	74689	1419916	389916	359952	2676	362628	396852	spneumo_pangenome_k32.r_0.01.S_greedytigs.k_19.d_na.M_default.C_xz
spneumo_pangenome_k32	0.01	greedytigs	19	na	ones	bzip	75514	1419916	75684	1344232	74858	74689	1419916	389916	359952	1810	361762	396892	spneumo_pangenome_k32.r_0.01.S_greedytigs.k_19.d_na.M_ones.C_bzip
spneumo_pangenome_k32	0.01	greedytigs	19	na	ones	xz	75514	1419916	75684	1344232	74858	74689	1419916	389916	359952	3468	363420	396892	spneumo_pangenome_k32.r_0.01.S_greedytigs.k_19.d_na.M_ones.C_xz
spneumo_pangenome_k32	0.01	greedytigs	19	na	runsapprox	bzip	75514	1419916	75684	1344232	74858	74689	1419916	389916	359952	1810	361762	396892	spneumo_pangenome_k32.r_0.01.S_greedytigs.k_19.d_na.M_runsapprox.C_bzip
spneumo_pangenome_k32	0.01	greedytigs	19	na	runsapprox	xz	75514	1419916	75684	1344232	74858	74689	1419916	389916	359952	3468	363420	396892	spneumo_pangenome_k32.r_0.01.S_greedytigs.k_19.d_na.M_runsapprox.C_xz
spneumo_pangenome_k32	0.05	greedytigs	19	na	default	bzip	377570	6826736	377570	6449166	358287	358287	6826736	1938380	1732380	22834	1755214	1979816	spneumo_pangenome_k32.r_0.05.S_greedytigs.k_19.d_na.M_default.C_bzip
spneumo_pangenome_k32	0.05	greedytigs	19	na	default	xz	377570	6826736	377570	6449166	358287	358287	6826736	1938380	1732380	38140	1770520	1979816	spneumo_pangenome_k32.r_0.05.S_greedytigs.k_19.d_na.M_default.C_xz
spneumo_pangenome_k32	0.05	greedytigs	19	na	ones	bzip	377570	6826736	381327	6445409	361973	358287	6826736	1938380	1732380	29053	1761433	1983540	spneumo_pangenome_k32.r_0.05.S_greedytigs.k_19.d_na.M_ones.C_bzip
spneumo_pangenome_k32	0.05	greedytigs	19	na	ones	xz	377570	6826736	381327	6445409	361973	358287	6826736	1938380	1732380	50876	1783256	1983540	spneumo_pangenome_k32.r_0.05.S_greedytigs.k_19.d_na.M_ones.C_xz
spneumo_pangenome_k32	0.05	greedytigs	19	na	runsapprox	bzip	377570	6826736	381327	6445409	361973	358287	6826736	1938380	1732380	29053	1761433	1983540	spneumo_pangenome_k32.r_0.05.S_greedytigs.k_19.d_na.M_runsapprox.C_bzip
spneumo_pangenome_k32	0.05	greedytigs	19	na	runsapprox	xz	377570	6826736	381327	6445409	361973	358287	6826736	1938380	1732380	50876	1783256	1983540	spneumo_pangenome_k32.r_0.05.S_greedytigs.k_19.d_na.M_runsapprox.C_xz
spneumo_pangenome_k32	0.1	greedytigs	19	na	default	bzip	755141	12959843	755141	12204702	678039	678039	12959843	3665820	3255800	68988	3324788	3769420	spneumo_pangenome_k32.r_0.1.S_greedytigs.k_19.d_na.M_default.C_bzip
spneumo_pangenome_k32	0.1	greedytigs	19	na	default	xz	755141	12959843	755141	12204702	678039	678039	12959843	3665820	3255800	113152	3368952	3769420	spneumo_pangenome_k32.r_0.1.S_greedytigs.k_19.d_na.M_default.C_xz
spneumo_pangenome_k32	0.1	greedytigs	19	na	ones	bzip	755141	12959843	769457	12190386	691842	678039	12959843	3665820	3255800	90022	3345822	3779852	spneumo_pangenome_k32.r_0.1.S_greedytigs.k_19.d_na.M_ones.C_bzip
spneumo_pangenome_k32	0.1	greedytigs	19	na	ones	xz	755141	12959843	769457	12190386	691842	678039	12959843	3665820	3255800	153656	3409456	3779852	spneumo_pangenome_k32.r_0.1.S_greedytigs.k_19.d_na.M_ones.C_xz
spneumo_pangenome_k32	0.1	greedytigs	19	na	runsapprox	bzip	755141	12959843	769457	12190386	691842	678039	12959843	3665820	3255800	90022	3345822	3779852	spneumo_pangenome_k32.r_0.1.S_greedytigs.k_19.d_na.M_runsapprox.C_bzip
spneumo_pangenome_k32	0.1	greedytigs	19	na	runsapprox	xz	755141	12959843	769457	12190386	691842	678039	12959843	3665820	3255800	153656	3409456	3779852	spneumo_pangenome_k32.r_0.1.S_greedytigs.k_19.d_na.M_runsapprox.C_xz
spneumo_pangenome_k32	0.2	greedytigs	19	na	default	bzip	1510282	23165765	1510289	21655476	1203082	1203082	23165765	6514124	5773800	193178	5966978	6693508	spneumo_pangenome_k32.r_0.2.S_greedytigs.k_19.d_na.M_default.C_bzip
spneumo_pangenome_k32	0.2	greedytigs	19	na	default	xz	1510282	23165765	1510289	21655476	1203082	1203082	23165765	6514124	5773800	315576	6089376	6693508	spneumo_pangenome_k32.r_0.2.S_greedytigs.k_19.d_na.M_default.C_xz
spneumo_pangenome_k32	0.2	greedytigs	19	na	ones	bzip	1510282	23165765	1562191	21603574	1251180	1203082	23165765	6514124	5773800	260183	6033983	6719436	spneumo_pangenome_k32.r_0.2.S_greedytigs.k_19.d_na.M_ones.C_bzip
spneumo_pangenome_k32	0.2	greedytigs	19	na	ones	xz	1510282	23165765	1562191	21603574	1251180	1203082	23165765	6514124	5773800	426112	6199912	6719436	spneumo_pangenome_k32.r_0.2.S_greedytigs.k_19.d_na.M_ones.C_xz
spneumo_pangenome_k32	0.2	greedytigs	19	na	runsapprox	bzip	1510282	23165765	1562191	21603574	1251180	1203082	23165765	6514124	5773800	260183	6033983	6719436	spneumo_pangenome_k32.r_0.2.S_greedytigs.k_19.d_na.M_runsapprox.C_bzip
spneumo_pangenome_k32	0.2	greedytigs	19	na	runsapprox	xz	1510282	23165765	1562191	21603574	1251180	1203082	23165765	6514124	5773800	426112	6199912	6719436	spneumo_pangenome_k32.r_0.2.S_greedytigs.k_19.d_na.M_runsapprox.C_xz
spneumo_pangenome_k32	0.3	greedytigs	19	na	default	bzip	2265423	30665356	2265514	28399842	1577769	1577769	30665356	8616392	7611948	338785	7950733	8912336	spneumo_pangenome_k32.r_0.3.S_greedytigs.k_19.d_na.M_default.C_bzip
spneumo_pangenome_k32	0.3	greedytigs	19	na	default	xz	2265423	30665356	2265514	28399842	1577769	1577769	30665356	8616392	7611948	544884	8156832	8912336	spneumo_pangenome_k32.r_0.3.S_greedytigs.k_19.d_na.M_default.C_xz
spneumo_pangenome_k32	0.3	greedytigs	19	na	ones	bzip	2265423	30665356	2368714	28296642	1669434	1577769	30665356	8616392	7611948	462701	8074649	8995236	spneumo_pangenome_k32.r_0.3.S_greedytigs.k_19.d_na.M_ones.C_bzip
spneumo_pangenome_k32	0.3	greedytigs	19	na	ones	xz	2265423	30665356	2368714	28296642	1669434	1577769	30665356	8616392	7611948	719940	8331888	8995236	spneumo_pangenome_k32.r_0.3.S_greedytigs.k_19.d_na.M_ones.C_xz
spneumo_pangenome_k32	0.3	greedytigs	19	na	runsapprox	bzip	2265423	30665356	2368714	28296642	1669434	1577769	30665356	8616392	7611948	462701	8074649	8995236	spneumo_pangenome_k32.r_0.3.S_greedytigs.k_19.d_na.M_runsapprox.C_bzip
spneumo_pangenome_k32	0.3	greedytigs	19	na	runsapprox	xz	2265423	30665356	2368714	28296642	1669434	1577769	30665356	8616392	7611948	719940	8331888	8995236	spneumo_pangenome_k32.r_0.3.S_greedytigs.k_19.d_na.M_runsapprox.C_xz
spneumo_pangenome_k32	0.4	greedytigs	19	na	default	bzip	3020564	35495839	3021013	32474826	1804157	1804157	35495839	9959908	8795796	486493	9282289	10414152	spneumo_pangenome_k32.r_0.4.S_greedytigs.k_19.d_na.M_default.C_bzip
spneumo_pangenome_k32	0.4	greedytigs	19	na	default	xz	3020564	35495839	3021013	32474826	1804157	1804157	35495839	9959908	8795796	760400	9556196	10414152	spneumo_pangenome_k32.r_0.4.S_greedytigs.k_19.d_na.M_default.C_xz
spneumo_pangenome_k32	0.4	greedytigs	19	na	ones	bzip	3020564	35495839	3180571	32315268	1939449	1804157	35495839	9959908	8795796	669972	9465768	10550120	spneumo_pangenome_k32.r_0.4.S_greedytigs.k_19.d_na.M_ones.C_bzip
spneumo_pangenome_k32	0.4	greedytigs	19	na	ones	xz	3020564	35495839	3180571	32315268	1939449	1804157	35495839	9959908	8795796	987792	9783588	10550120	spneumo_pangenome_k32.r_0.4.S_greedytigs.k_19.d_na.M_ones.C_xz
spneumo_pangenome_k32	0.4	greedytigs	19	na	runsapprox	bzip	3020564	35495839	3180571	32315268	1939449	1804157	35495839	9959908	8795796	669972	9465768	10550120	spneumo_pangenome_k32.r_0.4.S_greedytigs.k_19.d_na.M_runsapprox.C_bzip
spneumo_pangenome_k32	0.4	greedytigs	19	na	runsapprox	xz	3020564	35495839	3180571	32315268	1939449	1804157	35495839	9959908	8795796	987792	9783588	10550120	spneumo_pangenome_k32.r_0.4.S_greedytigs.k_19.d_na.M_runsapprox.C_xz
spneumo_pangenome_k32	0.5	greedytigs	19	na	default	bzip	3775706	37723930	3777334	33946596	1885922	1885922	37723930	10528100	9303308	617404	9920712	11156320	spneumo_pangenome_k32.r_0.5.S_greedytigs.k_19.d_na.M_default.C_bzip
spneumo_pangenome_k32	0.5	greedytigs	19	na	default	xz	3775706	37723930	3777334	33946596	1885922	1885922	37723930	10528100	9303308	929236	10232544	11156320	spneumo_pangenome_k32.r_0.5.S_greedytigs.k_19.d_na.M_default.C_xz
spneumo_pangenome_k32	0.5	greedytigs	19	na	ones	bzip	3775706	37723930	3988369	33735561	2055432	1885922	37723930	10528100	9303308	851448	10154756	11317236	spneumo_pangenome_k32.r_0.5.S_greedytigs.k_19.d_na.M_ones.C_bzip
spneumo_pangenome_k32	0.5	greedytigs	19	na	ones	xz	3775706	37723930	3988369	33735561	2055432	1885922	37723930	10528100	9303308	1192656	10495964	11317236	spneumo_pangenome_k32.r_0.5.S_greedytigs.k_19.d_na.M_ones.C_xz
spneumo_pangenome_k32	0.5	greedytigs	19	na	runsapprox	bzip	3775706	37723930	3988369	33735561	2055432	1885922	37723930	10528100	9303308	851448	10154756	11317236	spneumo_pangenome_k32.r_0.5.S_greedytigs.k_19.d_na.M_runsapprox.C_bzip
spneumo_pangenome_k32	0.5	greedytigs	19	na	runsapprox	xz	3775706	37723930	3988369	33735561	2055432	1885922	37723930	10528100	9303308	1192656	10495964	11317236	spneumo_pangenome_k32.r_0.5.S_greedytigs.k_19.d_na.M_runsapprox.C_xz
spneumo_pangenome_k32	0.6	greedytigs	19	na	default	bzip	4530847	37303021	4536667	32766354	1820353	1820353	37303021	10376736	9199140	711088	9910228	11362756	spneumo_pangenome_k32.r_0.6.S_greedytigs.k_19.d_na.M_default.C_bzip
spneumo_pangenome_k32	0.6	greedytigs	19	na	default	xz	4530847	37303021	4536667	32766354	1820353	1820353	37303021	10376736	9199140	1030416	10229556	11362756	spneumo_pangenome_k32.r_0.6.S_greedytigs.k_19.d_na.M_default.C_xz
spneumo_pangenome_k32	0.6	greedytigs	19	na	ones	bzip	4530847	37303021	4786152	32516869	2008322	1820353	37303021	10376736	9199140	977004	10176144	11354360	spneumo_pangenome_k32.r_0.6.S_greedytigs.k_19.d_na.M_ones.C_bzip
spneumo_pangenome_k32	0.6	greedytigs	19	na	ones	xz	4530847	37303021	4786152	32516869	2008322	1820353	37303021	10376736	9199140	1308028	10507168	11354360	spneumo_pangenome_k32.r_0.6.S_greedytigs.k_19.d_na.M_ones.C_xz
spneumo_pangenome_k32	0.6	greedytigs	19	na	runsapprox	bzip	4530847	37303021	4786152	32516869	2008322	1820353	37303021	10376736	9199140	977004	10176144	11354360	spneumo_pangenome_k32.r_0.6.S_greedytigs.k_19.d_na.M_runsapprox.C_bzip
spneumo_pangenome_k32	0.6	greedytigs	19	na	runsapprox	xz	4530847	37303021	4786152	32516869	2008322	1820353	37303021	10376736	9199140	1308028	10507168	11354360	spneumo_pangenome_k32.r_0.6.S_greedytigs.k_19.d_na.M_runsapprox.C_xz
spneumo_pangenome_k32	0.7	greedytigs	19	na	default	bzip	5285988	34321976	5304788	29017188	1612066	1612066	34321976	9500928	8440324	740108	9180432	10579440	spneumo_pangenome_k32.r_0.7.S_greedytigs.k_19.d_na.M_default.C_bzip
spneumo_pangenome_k32	0.7	greedytigs	19	na	default	xz	5285988	34321976	5304788	29017188	1612066	1612066	34321976	9500928	8440324	1047900	9488224	10579440	spneumo_pangenome_k32.r_0.7.S_greedytigs.k_19.d_na.M_default.C_xz
spneumo_pangenome_k32	0.7	greedytigs	19	na	ones	bzip	5285988	34321976	5570671	28751305	1797274	1612066	34321976	9500928	8440324	1012464	9452788	10596248	spneumo_pangenome_k32.r_0.7.S_greedytigs.k_19.d_na.M_ones.C_bzip
spneumo_pangenome_k32	0.7	greedytigs	19	na	ones	xz	5285988	34321976	5570671	28751305	1797274	1612066	34321976	9500928	8440324	1313128	9753452	10596248	spneumo_pangenome_k32.r_0.7.S_greedytigs.k_19.d_na.M_ones.C_xz
spneumo_pangenome_k32	0.7	greedytigs	19	na	runsapprox	bzip	5285988	34321976	5570671	28751305	1797274	1612066	34321976	9500928	8440324	1012464	9452788	10596248	spneumo_pangenome_k32.r_0.7.S_greedytigs.k_19.d_na.M_runsapprox.C_bzip
spneumo_pangenome_k32	0.7	greedytigs	19	na	runsapprox	xz	5285988	34321976	5570671	28751305	1797274	1612066	34321976	9500928	8440324	1313128	9753452	10596248	spneumo_pangenome_k32.r_0.7.S_greedytigs.k_19.d_na.M_runsapprox.C_xz
spneumo_pangenome_k32	0.8	greedytigs	19	na	default	bzip	6041129	28747023	6100377	22646646	1258147	1258147	28747023	7892564	7040980	681753	7722733	8835660	spneumo_pangenome_k32.r_0.8.S_greedytigs.k_19.d_na.M_default.C_bzip
spneumo_pangenome_k32	0.8	greedytigs	19	na	default	xz	6041129	28747023	6100377	22646646	1258147	1258147	28747023	7892564	7040980	947284	7988264	8835660	spneumo_pangenome_k32.r_0.8.S_greedytigs.k_19.d_na.M_default.C_xz
spneumo_pangenome_k32	0.8	greedytigs	19	na	ones	bzip	6041129	28747023	6350966	22396057	1413463	1258147	28747023	7892564	7040980	923942	7964922	9046916	spneumo_pangenome_k32.r_0.8.S_greedytigs.k_19.d_na.M_ones.C_bzip
spneumo_pangenome_k32	0.8	greedytigs	19	na	ones	xz	6041129	28747023	6350966	22396057	1413463	1258147	28747023	7892564	7040980	1174168	8215148	9046916	spneumo_pangenome_k32.r_0.8.S_greedytigs.k_19.d_na.M_ones.C_xz
spneumo_pangenome_k32	0.8	greedytigs	19	na	runsapprox	bzip	6041129	28747023	6350966	22396057	1413463	1258147	28747023	7892564	7040980	923942	7964922	9046916	spneumo_pangenome_k32.r_0.8.S_greedytigs.k_19.d_na.M_runsapprox.C_bzip
spneumo_pangenome_k32	0.8	greedytigs	19	na	runsapprox	xz	6041129	28747023	6350966	22396057	1413463	1258147	28747023	7892564	7040980	1174168	8215148	9046916	spneumo_pangenome_k32.r_0.8.S_greedytigs.k_19.d_na.M_runsapprox.C_xz
spneumo_pangenome_k32	0.9	greedytigs	19	na	default	bzip	6796270	20571066	7001460	13569606	753867	753867	20571066	5541512	4989184	501215	5490399	6346660	spneumo_pangenome_k32.r_0.9.S_greedytigs.k_19.d_na.M_default.C_bzip
spneumo_pangenome_k32	0.9	greedytigs	19	na	default	xz	6796270	20571066	7001460	13569606	753867	753867	20571066	5541512	4989184	687356	5676540	6346660	spneumo_pangenome_k32.r_0.9.S_greedytigs.k_19.d_na.M_default.C_xz
spneumo_pangenome_k32	0.9	greedytigs	19	na	ones	bzip	6796270	20571066	7190949	13380117	848265	753867	20571066	5541512	4989184	671200	5660384	6457744	spneumo_pangenome_k32.r_0.9.S_greedytigs.k_19.d_na.M_ones.C_bzip
spneumo_pangenome_k32	0.9	greedytigs	19	na	ones	xz	6796270	20571066	7190949	13380117	848265	753867	20571066	5541512	4989184	850256	5839440	6457744	spneumo_pangenome_k32.r_0.9.S_greedytigs.k_19.d_na.M_ones.C_xz
spneumo_pangenome_k32	0.9	greedytigs	19	na	runsapprox	bzip	6796270	20571066	7190949	13380117	848265	753867	20571066	5541512	4989184	671200	5660384	6457744	spneumo_pangenome_k32.r_0.9.S_greedytigs.k_19.d_na.M_runsapprox.C_bzip
spneumo_pangenome_k32	0.9	greedytigs	19	na	runsapprox	xz	6796270	20571066	7190949	13380117	848265	753867	20571066	5541512	4989184	850256	5839440	6457744	spneumo_pangenome_k32.r_0.9.S_greedytigs.k_19.d_na.M_runsapprox.C_xz
spneumo_pangenome_k32	1.0	greedytigs	19	na	default	bzip	7551412	9701400	8292324	1409076	78282	78282	9701400	2164344	2078148	80702	2158850	2389772	spneumo_pangenome_k32.r_1.0.S_greedytigs.k_19.d_na.M_default.C_bzip
spneumo_pangenome_k32	1.0	greedytigs	19	na	default	xz	7551412	9701400	8292324	1409076	78282	78282	9701400	2164344	2078148	150760	2228908	2389772	spneumo_pangenome_k32.r_1.0.S_greedytigs.k_19.d_na.M_default.C_xz
spneumo_pangenome_k32	1.0	greedytigs	19	na	ones	bzip	7551412	9701400	8349704	1351696	78639	78282	9701400	2164344	2078148	102196	2180344	2390472	spneumo_pangenome_k32.r_1.0.S_greedytigs.k_19.d_na.M_ones.C_bzip
spneumo_pangenome_k32	1.0	greedytigs	19	na	ones	xz	7551412	9701400	8349704	1351696	78639	78282	9701400	2164344	2078148	172304	2250452	2390472	spneumo_pangenome_k32.r_1.0.S_greedytigs.k_19.d_na.M_ones.C_xz
spneumo_pangenome_k32	1.0	greedytigs	19	na	runsapprox	bzip	7551412	9701400	8349201	1352199	78282	78282	9701400	2164344	2078148	101105	2179253	2389604	spneumo_pangenome_k32.r_1.0.S_greedytigs.k_19.d_na.M_runsapprox.C_bzip
spneumo_pangenome_k32	1.0	greedytigs	19	na	runsapprox	xz	7551412	9701400	8349201	1352199	78282	78282	9701400	2164344	2078148	171308	2249456	2389604	spneumo_pangenome_k32.r_1.0.S_greedytigs.k_19.d_na.M_runsapprox.C_xz
spneumo_pangenome_k32	0.000000001	matchtigs	19	na	default	bzip	1	19	1	18	1	1	19	84	84	41	125	84	spneumo_pangenome_k32.r_0.000000001.S_matchtigs.k_19.d_na.M_default.C_bzip
spneumo_pangenome_k32	0.000000001	matchtigs	19	na	default	xz	1	19	1	18	1	1	19	84	84	76	160	84	spneumo_pangenome_k32.r_0.000000001.S_matchtigs.k_19.d_na.M_default.C_xz
spneumo_pangenome_k32	0.000000001	matchtigs	19	na	ones	bzip	1	19	1	18	1	1	19	84	84	41	125	84	spneumo_pangenome_k32.r_0.000000001.S_matchtigs.k_19.d_na.M_ones.C_bzip
spneumo_pangenome_k32	0.000000001	matchtigs	19	na	ones	xz	1	19	1	18	1	1	19	84	84	76	160	84	spneumo_pangenome_k32.r_0.000000001.S_matchtigs.k_19.d_na.M_ones.C_xz
spneumo_pangenome_k32	0.000000001	matchtigs	19	na	runsapprox	bzip	1	19	1	18	1	1	19	84	84	41	125	84	spneumo_pangenome_k32.r_0.000000001.S_matchtigs.k_19.d_na.M_runsapprox.C_bzip
spneumo_pangenome_k32	0.000000001	matchtigs	19	na	runsapprox	xz	1	19	1	18	1	1	19	84	84	76	160	84	spneumo_pangenome_k32.r_0.000000001.S_matchtigs.k_19.d_na.M_runsapprox.C_xz
spneumo_pangenome_k32	0.0001	matchtigs	19	na	default	bzip	755	14327	755	13572	754	754	14327	4424	4172	47	4219	4408	spneumo_pangenome_k32.r_0.0001.S_matchtigs.k_19.d_na.M_default.C_bzip
spneumo_pangenome_k32	0.0001	matchtigs	19	na	default	xz	755	14327	755	13572	754	754	14327	4424	4172	132	4304	4408	spneumo_pangenome_k32.r_0.0001.S_matchtigs.k_19.d_na.M_default.C_xz
spneumo_pangenome_k32	0.0001	matchtigs	19	na	ones	bzip	755	14327	756	13571	755	754	14327	4424	4172	51	4223	4408	spneumo_pangenome_k32.r_0.0001.S_matchtigs.k_19.d_na.M_ones.C_bzip
spneumo_pangenome_k32	0.0001	matchtigs	19	na	ones	xz	755	14327	756	13571	755	754	14327	4424	4172	140	4312	4408	spneumo_pangenome_k32.r_0.0001.S_matchtigs.k_19.d_na.M_ones.C_xz
spneumo_pangenome_k32	0.0001	matchtigs	19	na	runsapprox	bzip	755	14327	756	13571	755	754	14327	4424	4172	51	4223	4408	spneumo_pangenome_k32.r_0.0001.S_matchtigs.k_19.d_na.M_runsapprox.C_bzip
spneumo_pangenome_k32	0.0001	matchtigs	19	na	runsapprox	xz	755	14327	756	13571	755	754	14327	4424	4172	140	4312	4408	spneumo_pangenome_k32.r_0.0001.S_matchtigs.k_19.d_na.M_runsapprox.C_xz
spneumo_pangenome_k32	0.001	matchtigs	19	na	default	bzip	7551	143307	7551	135756	7542	7542	143307	40048	37784	67	37851	40412	spneumo_pangenome_k32.r_0.001.S_matchtigs.k_19.d_na.M_default.C_bzip
spneumo_pangenome_k32	0.001	matchtigs	19	na	default	xz	7551	143307	7551	135756	7542	7542	143307	40048	37784	204	37988	40412	spneumo_pangenome_k32.r_0.001.S_matchtigs.k_19.d_na.M_default.C_xz
spneumo_pangenome_k32	0.001	matchtigs	19	na	ones	bzip	7551	143307	7551	135756	7542	7542	143307	40048	37784	67	37851	40412	spneumo_pangenome_k32.r_0.001.S_matchtigs.k_19.d_na.M_ones.C_bzip
spneumo_pangenome_k32	0.001	matchtigs	19	na	ones	xz	7551	143307	7551	135756	7542	7542	143307	40048	37784	204	37988	40412	spneumo_pangenome_k32.r_0.001.S_matchtigs.k_19.d_na.M_ones.C_xz
spneumo_pangenome_k32	0.001	matchtigs	19	na	runsapprox	bzip	7551	143307	7551	135756	7542	7542	143307	40048	37784	67	37851	40412	spneumo_pangenome_k32.r_0.001.S_matchtigs.k_19.d_na.M_runsapprox.C_bzip
spneumo_pangenome_k32	0.001	matchtigs	19	na	runsapprox	xz	7551	143307	7551	135756	7542	7542	143307	40048	37784	204	37988	40412	spneumo_pangenome_k32.r_0.001.S_matchtigs.k_19.d_na.M_runsapprox.C_xz
spneumo_pangenome_k32	0.01	matchtigs	19	na	default	bzip	75514	1419916	75514	1344402	74689	74689	1419916	389916	359952	1462	361414	396852	spneumo_pangenome_k32.r_0.01.S_matchtigs.k_19.d_na.M_default.C_bzip
spneumo_pangenome_k32	0.01	matchtigs	19	na	default	xz	75514	1419916	75514	1344402	74689	74689	1419916	389916	359952	2676	362628	396852	spneumo_pangenome_k32.r_0.01.S_matchtigs.k_19.d_na.M_default.C_xz
spneumo_pangenome_k32	0.01	matchtigs	19	na	ones	bzip	75514	1419916	75684	1344232	74858	74689	1419916	389916	359952	1810	361762	396892	spneumo_pangenome_k32.r_0.01.S_matchtigs.k_19.d_na.M_ones.C_bzip
spneumo_pangenome_k32	0.01	matchtigs	19	na	ones	xz	75514	1419916	75684	1344232	74858	74689	1419916	389916	359952	3468	363420	396892	spneumo_pangenome_k32.r_0.01.S_matchtigs.k_19.d_na.M_ones.C_xz
spneumo_pangenome_k32	0.01	matchtigs	19	na	runsapprox	bzip	75514	1419916	75684	1344232	74858	74689	1419916	389916	359952	1810	361762	396892	spneumo_pangenome_k32.r_0.01.S_matchtigs.k_19.d_na.M_runsapprox.C_bzip
spneumo_pangenome_k32	0.01	matchtigs	19	na	runsapprox	xz	75514	1419916	75684	1344232	74858	74689	1419916	389916	359952	3468	363420	396892	spneumo_pangenome_k32.r_0.01.S_matchtigs.k_19.d_na.M_runsapprox.C_xz
spneumo_pangenome_k32	0.05	matchtigs	19	na	default	bzip	377570	6826736	377570	6449166	358287	358287	6826736	1938380	1732380	22834	1755214	1979816	spneumo_pangenome_k32.r_0.05.S_matchtigs.k_19.d_na.M_default.C_bzip
spneumo_pangenome_k32	0.05	matchtigs	19	na	default	xz	377570	6826736	377570	6449166	358287	358287	6826736	1938380	1732380	38140	1770520	1979816	spneumo_pangenome_k32.r_0.05.S_matchtigs.k_19.d_na.M_default.C_xz
spneumo_pangenome_k32	0.05	matchtigs	19	na	ones	bzip	377570	6826736	381327	6445409	361973	358287	6826736	1938380	1732380	29053	1761433	1983540	spneumo_pangenome_k32.r_0.05.S_matchtigs.k_19.d_na.M_ones.C_bzip
spneumo_pangenome_k32	0.05	matchtigs	19	na	ones	xz	377570	6826736	381327	6445409	361973	358287	6826736	1938380	1732380	50876	1783256	1983540	spneumo_pangenome_k32.r_0.05.S_matchtigs.k_19.d_na.M_ones.C_xz
spneumo_pangenome_k32	0.05	matchtigs	19	na	runsapprox	bzip	377570	6826736	381327	6445409	361973	358287	6826736	1938380	1732380	29053	1761433	1983540	spneumo_pangenome_k32.r_0.05.S_matchtigs.k_19.d_na.M_runsapprox.C_bzip
spneumo_pangenome_k32	0.05	matchtigs	19	na	runsapprox	xz	377570	6826736	381327	6445409	361973	358287	6826736	1938380	1732380	50876	1783256	1983540	spneumo_pangenome_k32.r_0.05.S_matchtigs.k_19.d_na.M_runsapprox.C_xz
spneumo_pangenome_k32	0.1	matchtigs	19	na	default	bzip	755141	12959843	755141	12204702	678039	678039	12959843	3665820	3255800	68988	3324788	3769420	spneumo_pangenome_k32.r_0.1.S_matchtigs.k_19.d_na.M_default.C_bzip
spneumo_pangenome_k32	0.1	matchtigs	19	na	default	xz	755141	12959843	755141	12204702	678039	678039	12959843	3665820	3255800	113152	3368952	3769420	spneumo_pangenome_k32.r_0.1.S_matchtigs.k_19.d_na.M_default.C_xz
spneumo_pangenome_k32	0.1	matchtigs	19	na	ones	bzip	755141	12959843	769457	12190386	691842	678039	12959843	3665820	3255800	90022	3345822	3779852	spneumo_pangenome_k32.r_0.1.S_matchtigs.k_19.d_na.M_ones.C_bzip
spneumo_pangenome_k32	0.1	matchtigs	19	na	ones	xz	755141	12959843	769457	12190386	691842	678039	12959843	3665820	3255800	153656	3409456	3779852	spneumo_pangenome_k32.r_0.1.S_matchtigs.k_19.d_na.M_ones.C_xz
spneumo_pangenome_k32	0.1	matchtigs	19	na	runsapprox	bzip	755141	12959843	769457	12190386	691842	678039	12959843	3665820	3255800	90022	3345822	3779852	spneumo_pangenome_k32.r_0.1.S_matchtigs.k_19.d_na.M_runsapprox.C_bzip
spneumo_pangenome_k32	0.1	matchtigs	19	na	runsapprox	xz	755141	12959843	769457	12190386	691842	678039	12959843	3665820	3255800	153656	3409456	3779852	spneumo_pangenome_k32.r_0.1.S_matchtigs.k_19.d_na.M_runsapprox.C_xz
spneumo_pangenome_k32	0.2	matchtigs	19	na	default	bzip	1510282	23165867	1510283	21655584	1203088	1203088	23165867	6514100	5771516	193085	5964601	6670016	spneumo_pangenome_k32.r_0.2.S_matchtigs.k_19.d_na.M_default.C_bzip
spneumo_pangenome_k32	0.2	matchtigs	19	na	default	xz	1510282	23165867	1510283	21655584	1203088	1203088	23165867	6514100	5771516	315592	6087108	6670016	spneumo_pangenome_k32.r_0.2.S_matchtigs.k_19.d_na.M_default.C_xz
spneumo_pangenome_k32	0.2	matchtigs	19	na	ones	bzip	1510282	23165867	1562130	21603737	1251187	1203088	23165867	6514100	5771516	260169	6031685	6720188	spneumo_pangenome_k32.r_0.2.S_matchtigs.k_19.d_na.M_ones.C_bzip
spneumo_pangenome_k32	0.2	matchtigs	19	na	ones	xz	1510282	23165867	1562130	21603737	1251187	1203088	23165867	6514100	5771516	426312	6197828	6720188	spneumo_pangenome_k32.r_0.2.S_matchtigs.k_19.d_na.M_ones.C_xz
spneumo_pangenome_k32	0.2	matchtigs	19	na	runsapprox	bzip	1510282	23165867	1562130	21603737	1251187	1203088	23165867	6514100	5771516	260169	6031685	6720188	spneumo_pangenome_k32.r_0.2.S_matchtigs.k_19.d_na.M_runsapprox.C_bzip
spneumo_pangenome_k32	0.2	matchtigs	19	na	runsapprox	xz	1510282	23165867	1562130	21603737	1251187	1203088	23165867	6514100	5771516	426312	6197828	6720188	spneumo_pangenome_k32.r_0.2.S_matchtigs.k_19.d_na.M_runsapprox.C_xz
spneumo_pangenome_k32	0.3	matchtigs	19	na	default	bzip	2265423	30666382	2265424	28400958	1577831	1577831	30666382	8616148	7610892	338705	7949597	8910896	spneumo_pangenome_k32.r_0.3.S_matchtigs.k_19.d_na.M_default.C_bzip
spneumo_pangenome_k32	0.3	matchtigs	19	na	default	xz	2265423	30666382	2265424	28400958	1577831	1577831	30666382	8616148	7610892	545260	8156152	8910896	spneumo_pangenome_k32.r_0.3.S_matchtigs.k_19.d_na.M_default.C_xz
spneumo_pangenome_k32	0.3	matchtigs	19	na	ones	bzip	2265423	30666382	2368498	28297884	1669275	1577831	30666382	8616148	7610892	463024	8073916	8996936	spneumo_pangenome_k32.r_0.3.S_matchtigs.k_19.d_na.M_ones.C_bzip
spneumo_pangenome_k32	0.3	matchtigs	19	na	ones	xz	2265423	30666382	2368498	28297884	1669275	1577831	30666382	8616148	7610892	720772	8331664	8996936	spneumo_pangenome_k32.r_0.3.S_matchtigs.k_19.d_na.M_ones.C_xz
spneumo_pangenome_k32	0.3	matchtigs	19	na	runsapprox	bzip	2265423	30666382	2368498	28297884	1669275	1577831	30666382	8616148	7610892	463024	8073916	8996936	spneumo_pangenome_k32.r_0.3.S_matchtigs.k_19.d_na.M_runsapprox.C_bzip
spneumo_pangenome_k32	0.3	matchtigs	19	na	runsapprox	xz	2265423	30666382	2368498	28297884	1669275	1577831	30666382	8616148	7610892	720772	8331664	8996936	spneumo_pangenome_k32.r_0.3.S_matchtigs.k_19.d_na.M_runsapprox.C_xz
spneumo_pangenome_k32	0.4	matchtigs	19	na	default	bzip	3020564	35499806	3020588	32479218	1804401	1804401	35499806	9962304	8796036	486119	9282155	10413840	spneumo_pangenome_k32.r_0.4.S_matchtigs.k_19.d_na.M_default.C_bzip
spneumo_pangenome_k32	0.4	matchtigs	19	na	default	xz	3020564	35499806	3020588	32479218	1804401	1804401	35499806	9962304	8796036	759928	9555964	10413840	spneumo_pangenome_k32.r_0.4.S_matchtigs.k_19.d_na.M_default.C_xz
spneumo_pangenome_k32	0.4	matchtigs	19	na	ones	bzip	3020564	35499806	3179165	32320641	1938694	1804401	35499806	9962304	8796036	668607	9464643	10547996	spneumo_pangenome_k32.r_0.4.S_matchtigs.k_19.d_na.M_ones.C_bzip
spneumo_pangenome_k32	0.4	matchtigs	19	na	ones	xz	3020564	35499806	3179165	32320641	1938694	1804401	35499806	9962304	8796036	986932	9782968	10547996	spneumo_pangenome_k32.r_0.4.S_matchtigs.k_19.d_na.M_ones.C_xz
spneumo_pangenome_k32	0.4	matchtigs	19	na	runsapprox	bzip	3020564	35499806	3179165	32320641	1938694	1804401	35499806	9962304	8796036	668607	9464643	10547996	spneumo_pangenome_k32.r_0.4.S_matchtigs.k_19.d_na.M_runsapprox.C_bzip
spneumo_pangenome_k32	0.4	matchtigs	19	na	runsapprox	xz	3020564	35499806	3179165	32320641	1938694	1804401	35499806	9962304	8796036	986932	9782968	10547996	spneumo_pangenome_k32.r_0.4.S_matchtigs.k_19.d_na.M_runsapprox.C_xz
spneumo_pangenome_k32	0.6	matchtigs	19	na	default	bzip	4530847	37337217	4531353	32805864	1822548	1822548	37337217	10386388	9205684	710084	9915768	11158668	spneumo_pangenome_k32.r_0.6.S_matchtigs.k_19.d_na.M_default.C_bzip
spneumo_pangenome_k32	0.6	matchtigs	19	na	default	xz	4530847	37337217	4531353	32805864	1822548	1822548	37337217	10386388	9205684	1030736	10236420	11158668	spneumo_pangenome_k32.r_0.6.S_matchtigs.k_19.d_na.M_default.C_xz
spneumo_pangenome_k32	0.6	matchtigs	19	na	ones	bzip	4530847	37337217	4782341	32554876	2010692	1822548	37337217	10386388	9205684	977742	10183426	11356200	spneumo_pangenome_k32.r_0.6.S_matchtigs.k_19.d_na.M_ones.C_bzip
spneumo_pangenome_k32	0.6	matchtigs	19	na	ones	xz	4530847	37337217	4782341	32554876	2010692	1822548	37337217	10386388	9205684	1308788	10514472	11356200	spneumo_pangenome_k32.r_0.6.S_matchtigs.k_19.d_na.M_ones.C_xz
spneumo_pangenome_k32	0.6	matchtigs	19	na	runsapprox	bzip	4530847	37337217	4782341	32554876	2010692	1822548	37337217	10386388	9205684	977742	10183426	11356200	spneumo_pangenome_k32.r_0.6.S_matchtigs.k_19.d_na.M_runsapprox.C_bzip
spneumo_pangenome_k32	0.6	matchtigs	19	na	runsapprox	xz	4530847	37337217	4782341	32554876	2010692	1822548	37337217	10386388	9205684	1308788	10514472	11356200	spneumo_pangenome_k32.r_0.6.S_matchtigs.k_19.d_na.M_runsapprox.C_xz
spneumo_pangenome_k32	1.0	matchtigs	19	na	default	bzip	7551412	9596167	8124217	1471950	81775	81775	9596167	2157780	2072108	83299	2155407	2392640	spneumo_pangenome_k32.r_1.0.S_matchtigs.k_19.d_na.M_default.C_bzip
spneumo_pangenome_k32	1.0	matchtigs	19	na	default	xz	7551412	9596167	8124217	1471950	81775	81775	9596167	2157780	2072108	153368	2225476	2392640	spneumo_pangenome_k32.r_1.0.S_matchtigs.k_19.d_na.M_default.C_xz
spneumo_pangenome_k32	1.0	matchtigs	19	na	ones	bzip	7551412	9596167	8183473	1412694	82137	81775	9596167	2157780	2072108	105764	2177872	2393776	spneumo_pangenome_k32.r_1.0.S_matchtigs.k_19.d_na.M_ones.C_bzip
spneumo_pangenome_k32	1.0	matchtigs	19	na	ones	xz	7551412	9596167	8183473	1412694	82137	81775	9596167	2157780	2072108	175716	2247824	2393776	spneumo_pangenome_k32.r_1.0.S_matchtigs.k_19.d_na.M_ones.C_xz
spneumo_pangenome_k32	1.0	matchtigs	19	na	runsapprox	bzip	7551412	9596167	8182996	1413171	81775	81775	9596167	2157780	2072108	104689	2176797	2392960	spneumo_pangenome_k32.r_1.0.S_matchtigs.k_19.d_na.M_runsapprox.C_bzip
spneumo_pangenome_k32	1.0	matchtigs	19	na	runsapprox	xz	7551412	9596167	8182996	1413171	81775	81775	9596167	2157780	2072108	174732	2246840	2392960	spneumo_pangenome_k32.r_1.0.S_matchtigs.k_19.d_na.M_runsapprox.C_xz
spneumo_pangenome_k32	0.000000001	prophasm	19	na	default	bzip	1	19	1	18	1	1	19	84	84	41	125	84	spneumo_pangenome_k32.r_0.000000001.S_prophasm.k_19.d_na.M_default.C_bzip
spneumo_pangenome_k32	0.000000001	prophasm	19	na	default	xz	1	19	1	18	1	1	19	84	84	76	160	84	spneumo_pangenome_k32.r_0.000000001.S_prophasm.k_19.d_na.M_default.C_xz
spneumo_pangenome_k32	0.000000001	prophasm	19	na	ones	bzip	1	19	1	18	1	1	19	84	84	41	125	84	spneumo_pangenome_k32.r_0.000000001.S_prophasm.k_19.d_na.M_ones.C_bzip
spneumo_pangenome_k32	0.000000001	prophasm	19	na	ones	xz	1	19	1	18	1	1	19	84	84	76	160	84	spneumo_pangenome_k32.r_0.000000001.S_prophasm.k_19.d_na.M_ones.C_xz
spneumo_pangenome_k32	0.000000001	prophasm	19	na	runsapprox	bzip	1	19	1	18	1	1	19	84	84	41	125	84	spneumo_pangenome_k32.r_0.000000001.S_prophasm.k_19.d_na.M_runsapprox.C_bzip
spneumo_pangenome_k32	0.000000001	prophasm	19	na	runsapprox	xz	1	19	1	18	1	1	19	84	84	76	160	84	spneumo_pangenome_k32.r_0.000000001.S_prophasm.k_19.d_na.M_runsapprox.C_xz
spneumo_pangenome_k32	0.0001	prophasm	19	na	default	bzip	755	14327	755	13572	754	754	14327	4788	4236	47	4283	4892	spneumo_pangenome_k32.r_0.0001.S_prophasm.k_19.d_na.M_default.C_bzip
spneumo_pangenome_k32	0.0001	prophasm	19	na	default	xz	755	14327	755	13572	754	754	14327	4788	4236	132	4368	4892	spneumo_pangenome_k32.r_0.0001.S_prophasm.k_19.d_na.M_default.C_xz
spneumo_pangenome_k32	0.0001	prophasm	19	na	ones	bzip	755	14327	755	13572	754	754	14327	4788	4236	47	4283	4892	spneumo_pangenome_k32.r_0.0001.S_prophasm.k_19.d_na.M_ones.C_bzip
spneumo_pangenome_k32	0.0001	prophasm	19	na	ones	xz	755	14327	755	13572	754	754	14327	4788	4236	132	4368	4892	spneumo_pangenome_k32.r_0.0001.S_prophasm.k_19.d_na.M_ones.C_xz
spneumo_pangenome_k32	0.0001	prophasm	19	na	runsapprox	bzip	755	14327	755	13572	754	754	14327	4788	4236	47	4283	4892	spneumo_pangenome_k32.r_0.0001.S_prophasm.k_19.d_na.M_runsapprox.C_bzip
spneumo_pangenome_k32	0.0001	prophasm	19	na	runsapprox	xz	755	14327	755	13572	754	754	14327	4788	4236	132	4368	4892	spneumo_pangenome_k32.r_0.0001.S_prophasm.k_19.d_na.M_runsapprox.C_xz
spneumo_pangenome_k32	0.001	prophasm	19	na	default	bzip	7551	143307	7551	135756	7542	7542	143307	43892	39180	67	39247	44748	spneumo_pangenome_k32.r_0.001.S_prophasm.k_19.d_na.M_default.C_bzip
spneumo_pangenome_k32	0.001	prophasm	19	na	default	xz	7551	143307	7551	135756	7542	7542	143307	43892	39180	212	39392	44748	spneumo_pangenome_k32.r_0.001.S_prophasm.k_19.d_na.M_default.C_xz
spneumo_pangenome_k32	0.001	prophasm	19	na	ones	bzip	7551	143307	7553	135754	7544	7542	143307	43892	39180	74	39254	44748	spneumo_pangenome_k32.r_0.001.S_prophasm.k_19.d_na.M_ones.C_bzip
spneumo_pangenome_k32	0.001	prophasm	19	na	ones	xz	7551	143307	7553	135754	7544	7542	143307	43892	39180	224	39404	44748	spneumo_pangenome_k32.r_0.001.S_prophasm.k_19.d_na.M_ones.C_xz
spneumo_pangenome_k32	0.001	prophasm	19	na	runsapprox	bzip	7551	143307	7553	135754	7544	7542	143307	43892	39180	74	39254	44748	spneumo_pangenome_k32.r_0.001.S_prophasm.k_19.d_na.M_runsapprox.C_bzip
spneumo_pangenome_k32	0.001	prophasm	19	na	runsapprox	xz	7551	143307	7553	135754	7544	7542	143307	43892	39180	224	39404	44748	spneumo_pangenome_k32.r_0.001.S_prophasm.k_19.d_na.M_runsapprox.C_xz
spneumo_pangenome_k32	0.01	prophasm	19	na	default	bzip	75514	1419916	75514	1344402	74689	74689	1419916	420168	373164	1429	374593	423708	spneumo_pangenome_k32.r_0.01.S_prophasm.k_19.d_na.M_default.C_bzip
spneumo_pangenome_k32	0.01	prophasm	19	na	default	xz	75514	1419916	75514	1344402	74689	74689	1419916	420168	373164	2564	375728	423708	spneumo_pangenome_k32.r_0.01.S_prophasm.k_19.d_na.M_default.C_xz
spneumo_pangenome_k32	0.01	prophasm	19	na	ones	bzip	75514	1419916	75694	1344222	74868	74689	1419916	420168	373164	1798	374962	425868	spneumo_pangenome_k32.r_0.01.S_prophasm.k_19.d_na.M_ones.C_bzip
spneumo_pangenome_k32	0.01	prophasm	19	na	ones	xz	75514	1419916	75694	1344222	74868	74689	1419916	420168	373164	3432	376596	425868	spneumo_pangenome_k32.r_0.01.S_prophasm.k_19.d_na.M_ones.C_xz
spneumo_pangenome_k32	0.01	prophasm	19	na	runsapprox	bzip	75514	1419916	75694	1344222	74868	74689	1419916	420168	373164	1798	374962	425868	spneumo_pangenome_k32.r_0.01.S_prophasm.k_19.d_na.M_runsapprox.C_bzip
spneumo_pangenome_k32	0.01	prophasm	19	na	runsapprox	xz	75514	1419916	75694	1344222	74868	74689	1419916	420168	373164	3432	376596	425868	spneumo_pangenome_k32.r_0.01.S_prophasm.k_19.d_na.M_runsapprox.C_xz
spneumo_pangenome_k32	0.05	prophasm	19	na	default	bzip	377570	6826736	377570	6449166	358287	358287	6826736	1985572	1760596	21496	1782092	1966984	spneumo_pangenome_k32.r_0.05.S_prophasm.k_19.d_na.M_default.C_bzip
spneumo_pangenome_k32	0.05	prophasm	19	na	default	xz	377570	6826736	377570	6449166	358287	358287	6826736	1985572	1760596	35784	1796380	1966984	spneumo_pangenome_k32.r_0.05.S_prophasm.k_19.d_na.M_default.C_xz
spneumo_pangenome_k32	0.05	prophasm	19	na	ones	bzip	377570	6826736	381448	6445288	362098	358287	6826736	1985572	1760596	28013	1788609	1970416	spneumo_pangenome_k32.r_0.05.S_prophasm.k_19.d_na.M_ones.C_bzip
spneumo_pangenome_k32	0.05	prophasm	19	na	ones	xz	377570	6826736	381448	6445288	362098	358287	6826736	1985572	1760596	49372	1809968	1970416	spneumo_pangenome_k32.r_0.05.S_prophasm.k_19.d_na.M_ones.C_xz
spneumo_pangenome_k32	0.05	prophasm	19	na	runsapprox	bzip	377570	6826736	381448	6445288	362098	358287	6826736	1985572	1760596	28013	1788609	1970416	spneumo_pangenome_k32.r_0.05.S_prophasm.k_19.d_na.M_runsapprox.C_bzip
spneumo_pangenome_k32	0.05	prophasm	19	na	runsapprox	xz	377570	6826736	381448	6445288	362098	358287	6826736	1985572	1760596	49372	1809968	1970416	spneumo_pangenome_k32.r_0.05.S_prophasm.k_19.d_na.M_runsapprox.C_xz
spneumo_pangenome_k32	0.1	prophasm	19	na	default	bzip	755141	12959843	755141	12204702	678039	678039	12959843	3732260	3314832	64535	3379367	3751636	spneumo_pangenome_k32.r_0.1.S_prophasm.k_19.d_na.M_default.C_bzip
spneumo_pangenome_k32	0.1	prophasm	19	na	default	xz	755141	12959843	755141	12204702	678039	678039	12959843	3732260	3314832	106524	3421356	3751636	spneumo_pangenome_k32.r_0.1.S_prophasm.k_19.d_na.M_default.C_xz
spneumo_pangenome_k32	0.1	prophasm	19	na	ones	bzip	755141	12959843	770093	12189750	692464	678039	12959843	3732260	3314832	86687	3401519	3774908	spneumo_pangenome_k32.r_0.1.S_prophasm.k_19.d_na.M_ones.C_bzip
spneumo_pangenome_k32	0.1	prophasm	19	na	ones	xz	755141	12959843	770093	12189750	692464	678039	12959843	3732260	3314832	149300	3464132	3774908	spneumo_pangenome_k32.r_0.1.S_prophasm.k_19.d_na.M_ones.C_xz
spneumo_pangenome_k32	0.1	prophasm	19	na	runsapprox	bzip	755141	12959843	770093	12189750	692464	678039	12959843	3732260	3314832	86687	3401519	3774908	spneumo_pangenome_k32.r_0.1.S_prophasm.k_19.d_na.M_runsapprox.C_bzip
spneumo_pangenome_k32	0.1	prophasm	19	na	runsapprox	xz	755141	12959843	770093	12189750	692464	678039	12959843	3732260	3314832	149300	3464132	3774908	spneumo_pangenome_k32.r_0.1.S_prophasm.k_19.d_na.M_runsapprox.C_xz
spneumo_pangenome_k32	0.2	prophasm	19	na	default	bzip	1510282	23165884	1510282	21655602	1203089	1203089	23165884	6609748	5860068	180607	6040675	6706560	spneumo_pangenome_k32.r_0.2.S_prophasm.k_19.d_na.M_default.C_bzip
spneumo_pangenome_k32	0.2	prophasm	19	na	default	xz	1510282	23165884	1510282	21655602	1203089	1203089	23165884	6609748	5860068	296052	6156120	6706560	spneumo_pangenome_k32.r_0.2.S_prophasm.k_19.d_na.M_default.C_xz
spneumo_pangenome_k32	0.2	prophasm	19	na	ones	bzip	1510282	23165884	1563881	21602003	1252804	1203089	23165884	6609748	5860068	250507	6110575	6793540	spneumo_pangenome_k32.r_0.2.S_prophasm.k_19.d_na.M_ones.C_bzip
spneumo_pangenome_k32	0.2	prophasm	19	na	ones	xz	1510282	23165884	1563881	21602003	1252804	1203089	23165884	6609748	5860068	413512	6273580	6793540	spneumo_pangenome_k32.r_0.2.S_prophasm.k_19.d_na.M_ones.C_xz
spneumo_pangenome_k32	0.2	prophasm	19	na	runsapprox	bzip	1510282	23165884	1563881	21602003	1252804	1203089	23165884	6609748	5860068	250507	6110575	6793540	spneumo_pangenome_k32.r_0.2.S_prophasm.k_19.d_na.M_runsapprox.C_bzip
spneumo_pangenome_k32	0.2	prophasm	19	na	runsapprox	xz	1510282	23165884	1563881	21602003	1252804	1203089	23165884	6609748	5860068	413512	6273580	6793540	spneumo_pangenome_k32.r_0.2.S_prophasm.k_19.d_na.M_runsapprox.C_xz
spneumo_pangenome_k32	0.3	prophasm	19	na	default	bzip	2265423	30666399	2265423	28400976	1577832	1577832	30666399	8682236	7691328	316421	8007749	8931060	spneumo_pangenome_k32.r_0.3.S_prophasm.k_19.d_na.M_default.C_bzip
spneumo_pangenome_k32	0.3	prophasm	19	na	default	xz	2265423	30666399	2265423	28400976	1577832	1577832	30666399	8682236	7691328	504996	8196324	8931060	spneumo_pangenome_k32.r_0.3.S_prophasm.k_19.d_na.M_default.C_xz
spneumo_pangenome_k32	0.3	prophasm	19	na	ones	bzip	2265423	30666399	2371101	28295298	1671884	1577832	30666399	8682236	7691328	444711	8136039	9048892	spneumo_pangenome_k32.r_0.3.S_prophasm.k_19.d_na.M_ones.C_bzip
spneumo_pangenome_k32	0.3	prophasm	19	na	ones	xz	2265423	30666399	2371101	28295298	1671884	1577832	30666399	8682236	7691328	694920	8386248	9048892	spneumo_pangenome_k32.r_0.3.S_prophasm.k_19.d_na.M_ones.C_xz
spneumo_pangenome_k32	0.3	prophasm	19	na	runsapprox	bzip	2265423	30666399	2371101	28295298	1671884	1577832	30666399	8682236	7691328	444711	8136039	9048892	spneumo_pangenome_k32.r_0.3.S_prophasm.k_19.d_na.M_runsapprox.C_bzip
spneumo_pangenome_k32	0.3	prophasm	19	na	runsapprox	xz	2265423	30666399	2371101	28295298	1671884	1577832	30666399	8682236	7691328	694920	8386248	9048892	spneumo_pangenome_k32.r_0.3.S_prophasm.k_19.d_na.M_runsapprox.C_xz
spneumo_pangenome_k32	0.4	prophasm	19	na	default	bzip	3020564	35500070	3020564	32479506	1804417	1804417	35500070	9968660	8835984	452753	9288737	10393380	spneumo_pangenome_k32.r_0.4.S_prophasm.k_19.d_na.M_default.C_bzip
spneumo_pangenome_k32	0.4	prophasm	19	na	default	xz	3020564	35500070	3020564	32479506	1804417	1804417	35500070	9968660	8835984	695684	9531668	10393380	spneumo_pangenome_k32.r_0.4.S_prophasm.k_19.d_na.M_default.C_xz
spneumo_pangenome_k32	0.4	prophasm	19	na	ones	bzip	3020564	35500070	3185292	32314778	1943889	1804417	35500070	9968660	8835984	643111	9479095	10538072	spneumo_pangenome_k32.r_0.4.S_prophasm.k_19.d_na.M_ones.C_bzip
spneumo_pangenome_k32	0.4	prophasm	19	na	ones	xz	3020564	35500070	3185292	32314778	1943889	1804417	35500070	9968660	8835984	947496	9783480	10538072	spneumo_pangenome_k32.r_0.4.S_prophasm.k_19.d_na.M_ones.C_xz
spneumo_pangenome_k32	0.4	prophasm	19	na	runsapprox	bzip	3020564	35500070	3185292	32314778	1943889	1804417	35500070	9968660	8835984	643111	9479095	10538072	spneumo_pangenome_k32.r_0.4.S_prophasm.k_19.d_na.M_runsapprox.C_bzip
spneumo_pangenome_k32	0.4	prophasm	19	na	runsapprox	xz	3020564	35500070	3185292	32314778	1943889	1804417	35500070	9968660	8835984	947496	9783480	10538072	spneumo_pangenome_k32.r_0.4.S_prophasm.k_19.d_na.M_runsapprox.C_xz
spneumo_pangenome_k32	0.5	prophasm	19	na	default	bzip	3775706	37737170	3775706	33961464	1886748	1886748	37737170	10519956	9336048	571918	9907966	11140304	spneumo_pangenome_k32.r_0.5.S_prophasm.k_19.d_na.M_default.C_bzip
spneumo_pangenome_k32	0.5	prophasm	19	na	default	xz	3775706	37737170	3775706	33961464	1886748	1886748	37737170	10519956	9336048	847328	10183376	11140304	spneumo_pangenome_k32.r_0.5.S_prophasm.k_19.d_na.M_default.C_xz
spneumo_pangenome_k32	0.5	prophasm	19	na	ones	bzip	3775706	37737170	3994058	33743112	2061684	1886748	37737170	10519956	9336048	814118	10150166	11300728	spneumo_pangenome_k32.r_0.5.S_prophasm.k_19.d_na.M_ones.C_bzip
spneumo_pangenome_k32	0.5	prophasm	19	na	ones	xz	3775706	37737170	3994058	33743112	2061684	1886748	37737170	10519956	9336048	1140276	10476324	11300728	spneumo_pangenome_k32.r_0.5.S_prophasm.k_19.d_na.M_ones.C_xz
spneumo_pangenome_k32	0.5	prophasm	19	na	runsapprox	bzip	3775706	37737170	3994058	33743112	2061684	1886748	37737170	10519956	9336048	814118	10150166	11300728	spneumo_pangenome_k32.r_0.5.S_prophasm.k_19.d_na.M_runsapprox.C_bzip
spneumo_pangenome_k32	0.5	prophasm	19	na	runsapprox	xz	3775706	37737170	3994058	33743112	2061684	1886748	37737170	10519956	9336048	1140276	10476324	11300728	spneumo_pangenome_k32.r_0.5.S_prophasm.k_19.d_na.M_runsapprox.C_xz
spneumo_pangenome_k32	0.6	prophasm	19	na	default	bzip	4530847	37340923	4530847	32810076	1822782	1822782	37340923	10333448	9198756	651717	9850473	11077168	spneumo_pangenome_k32.r_0.6.S_prophasm.k_19.d_na.M_default.C_bzip
spneumo_pangenome_k32	0.6	prophasm	19	na	default	xz	4530847	37340923	4530847	32810076	1822782	1822782	37340923	10333448	9198756	942288	10141044	11077168	spneumo_pangenome_k32.r_0.6.S_prophasm.k_19.d_na.M_default.C_xz
spneumo_pangenome_k32	0.6	prophasm	19	na	ones	bzip	4530847	37340923	4788081	32552842	2015272	1822782	37340923	10333448	9198756	925450	10124206	11284392	spneumo_pangenome_k32.r_0.6.S_prophasm.k_19.d_na.M_ones.C_bzip
spneumo_pangenome_k32	0.6	prophasm	19	na	ones	xz	4530847	37340923	4788081	32552842	2015272	1822782	37340923	10333448	9198756	1249392	10448148	11284392	spneumo_pangenome_k32.r_0.6.S_prophasm.k_19.d_na.M_ones.C_xz
spneumo_pangenome_k32	0.6	prophasm	19	na	runsapprox	bzip	4530847	37340923	4788081	32552842	2015272	1822782	37340923	10333448	9198756	925450	10124206	11284392	spneumo_pangenome_k32.r_0.6.S_prophasm.k_19.d_na.M_runsapprox.C_bzip
spneumo_pangenome_k32	0.6	prophasm	19	na	runsapprox	xz	4530847	37340923	4788081	32552842	2015272	1822782	37340923	10333448	9198756	1249392	10448148	11284392	spneumo_pangenome_k32.r_0.6.S_prophasm.k_19.d_na.M_runsapprox.C_xz
spneumo_pangenome_k32	0.7	prophasm	19	na	default	bzip	5285988	34413534	5285988	29127546	1618197	1618197	34413534	9463064	8446964	671001	9117965	10317468	spneumo_pangenome_k32.r_0.7.S_prophasm.k_19.d_na.M_default.C_bzip
spneumo_pangenome_k32	0.7	prophasm	19	na	default	xz	5285988	34413534	5285988	29127546	1618197	1618197	34413534	9463064	8446964	960560	9407524	10317468	spneumo_pangenome_k32.r_0.7.S_prophasm.k_19.d_na.M_default.C_xz
spneumo_pangenome_k32	0.7	prophasm	19	na	ones	bzip	5285988	34413534	5563071	28850463	1807121	1618197	34413534	9463064	8446964	953405	9400369	10534460	spneumo_pangenome_k32.r_0.7.S_prophasm.k_19.d_na.M_ones.C_bzip
spneumo_pangenome_k32	0.7	prophasm	19	na	ones	xz	5285988	34413534	5563071	28850463	1807121	1618197	34413534	9463064	8446964	1254876	9701840	10534460	spneumo_pangenome_k32.r_0.7.S_prophasm.k_19.d_na.M_ones.C_xz
spneumo_pangenome_k32	0.7	prophasm	19	na	runsapprox	bzip	5285988	34413534	5563071	28850463	1807121	1618197	34413534	9463064	8446964	953405	9400369	10534460	spneumo_pangenome_k32.r_0.7.S_prophasm.k_19.d_na.M_runsapprox.C_bzip
spneumo_pangenome_k32	0.7	prophasm	19	na	runsapprox	xz	5285988	34413534	5563071	28850463	1807121	1618197	34413534	9463064	8446964	1254876	9701840	10534460	spneumo_pangenome_k32.r_0.7.S_prophasm.k_19.d_na.M_runsapprox.C_xz
spneumo_pangenome_k32	0.8	prophasm	19	na	default	bzip	6041129	28949225	6041129	22908096	1272672	1272672	28949225	7897884	7081716	610836	7692552	8896964	spneumo_pangenome_k32.r_0.8.S_prophasm.k_19.d_na.M_default.C_bzip
spneumo_pangenome_k32	0.8	prophasm	19	na	default	xz	6041129	28949225	6041129	22908096	1272672	1272672	28949225	7897884	7081716	870452	7952168	8896964	spneumo_pangenome_k32.r_0.8.S_prophasm.k_19.d_na.M_default.C_xz
spneumo_pangenome_k32	0.8	prophasm	19	na	ones	bzip	6041129	28949225	6307045	22642180	1430493	1272672	28949225	7897884	7081716	867392	7949108	9063320	spneumo_pangenome_k32.r_0.8.S_prophasm.k_19.d_na.M_ones.C_bzip
spneumo_pangenome_k32	0.8	prophasm	19	na	ones	xz	6041129	28949225	6307045	22642180	1430493	1272672	28949225	7897884	7081716	1125696	8207412	9063320	spneumo_pangenome_k32.r_0.8.S_prophasm.k_19.d_na.M_ones.C_xz
spneumo_pangenome_k32	0.8	prophasm	19	na	runsapprox	bzip	6041129	28949225	6307045	22642180	1430493	1272672	28949225	7897884	7081716	867392	7949108	9063320	spneumo_pangenome_k32.r_0.8.S_prophasm.k_19.d_na.M_runsapprox.C_bzip
spneumo_pangenome_k32	0.8	prophasm	19	na	runsapprox	xz	6041129	28949225	6307045	22642180	1430493	1272672	28949225	7897884	7081716	1125696	8207412	9063320	spneumo_pangenome_k32.r_0.8.S_prophasm.k_19.d_na.M_runsapprox.C_xz
spneumo_pangenome_k32	0.9	prophasm	19	na	default	bzip	6796270	20999854	6796270	14203584	789088	789088	20999854	5623924	5086832	451663	5538495	6442868	spneumo_pangenome_k32.r_0.9.S_prophasm.k_19.d_na.M_default.C_bzip
spneumo_pangenome_k32	0.9	prophasm	19	na	default	xz	6796270	20999854	6796270	14203584	789088	789088	20999854	5623924	5086832	658036	5744868	6442868	spneumo_pangenome_k32.r_0.9.S_prophasm.k_19.d_na.M_default.C_xz
spneumo_pangenome_k32	0.9	prophasm	19	na	ones	bzip	6796270	20999854	7015403	13984451	885026	789088	20999854	5623924	5086832	640854	5727686	6563028	spneumo_pangenome_k32.r_0.9.S_prophasm.k_19.d_na.M_ones.C_bzip
spneumo_pangenome_k32	0.9	prophasm	19	na	ones	xz	6796270	20999854	7015403	13984451	885026	789088	20999854	5623924	5086832	839508	5926340	6563028	spneumo_pangenome_k32.r_0.9.S_prophasm.k_19.d_na.M_ones.C_xz
spneumo_pangenome_k32	0.9	prophasm	19	na	runsapprox	bzip	6796270	20999854	7015403	13984451	885026	789088	20999854	5623924	5086832	640854	5727686	6563028	spneumo_pangenome_k32.r_0.9.S_prophasm.k_19.d_na.M_runsapprox.C_bzip
spneumo_pangenome_k32	0.9	prophasm	19	na	runsapprox	xz	6796270	20999854	7015403	13984451	885026	789088	20999854	5623924	5086832	839508	5926340	6563028	spneumo_pangenome_k32.r_0.9.S_prophasm.k_19.d_na.M_runsapprox.C_xz
spneumo_pangenome_k32	1.0	prophasm	19	na	default	bzip	7551412	10580038	7551412	3028626	168257	168257	10580038	2420356	2319344	120426	2439770	2848164	spneumo_pangenome_k32.r_1.0.S_prophasm.k_19.d_na.M_default.C_bzip
spneumo_pangenome_k32	1.0	prophasm	19	na	default	xz	7551412	10580038	7551412	3028626	168257	168257	10580038	2420356	2319344	191416	2510760	2848164	spneumo_pangenome_k32.r_1.0.S_prophasm.k_19.d_na.M_default.C_xz
spneumo_pangenome_k32	1.0	prophasm	19	na	ones	bzip	7551412	10580038	7679052	2900986	169146	168257	10580038	2420356	2319344	172805	2492149	2854412	spneumo_pangenome_k32.r_1.0.S_prophasm.k_19.d_na.M_ones.C_bzip
spneumo_pangenome_k32	1.0	prophasm	19	na	ones	xz	7551412	10580038	7679052	2900986	169146	168257	10580038	2420356	2319344	244120	2563464	2854412	spneumo_pangenome_k32.r_1.0.S_prophasm.k_19.d_na.M_ones.C_xz
spneumo_pangenome_k32	1.0	prophasm	19	na	runsapprox	bzip	7551412	10580038	7679052	2900986	169146	168257	10580038	2420356	2319344	172805	2492149	2854412	spneumo_pangenome_k32.r_1.0.S_prophasm.k_19.d_na.M_runsapprox.C_bzip
spneumo_pangenome_k32	1.0	prophasm	19	na	runsapprox	xz	7551412	10580038	7679052	2900986	169146	168257	10580038	2420356	2319344	244120	2563464	2854412	spneumo_pangenome_k32.r_1.0.S_prophasm.k_19.d_na.M_runsapprox.C_xz
spneumo_pangenome_k32	0.000000001	eulertigs	21	na	default	bzip	1	21	1	20	1	1	21	88	88	41	129	88	spneumo_pangenome_k32.r_0.000000001.S_eulertigs.k_21.d_na.M_default.C_bzip
spneumo_pangenome_k32	0.000000001	eulertigs	21	na	default	xz	1	21	1	20	1	1	21	88	88	76	164	88	spneumo_pangenome_k32.r_0.000000001.S_eulertigs.k_21.d_na.M_default.C_xz
spneumo_pangenome_k32	0.000000001	eulertigs	21	na	ones	bzip	1	21	1	20	1	1	21	88	88	41	129	88	spneumo_pangenome_k32.r_0.000000001.S_eulertigs.k_21.d_na.M_ones.C_bzip
spneumo_pangenome_k32	0.000000001	eulertigs	21	na	ones	xz	1	21	1	20	1	1	21	88	88	76	164	88	spneumo_pangenome_k32.r_0.000000001.S_eulertigs.k_21.d_na.M_ones.C_xz
spneumo_pangenome_k32	0.000000001	eulertigs	21	na	runsapprox	bzip	1	21	1	20	1	1	21	88	88	41	129	88	spneumo_pangenome_k32.r_0.000000001.S_eulertigs.k_21.d_na.M_runsapprox.C_bzip
spneumo_pangenome_k32	0.000000001	eulertigs	21	na	runsapprox	xz	1	21	1	20	1	1	21	88	88	76	164	88	spneumo_pangenome_k32.r_0.000000001.S_eulertigs.k_21.d_na.M_runsapprox.C_xz
spneumo_pangenome_k32	0.0001	eulertigs	21	na	default	bzip	791	16611	791	15820	791	791	16611	5028	4760	47	4807	5004	spneumo_pangenome_k32.r_0.0001.S_eulertigs.k_21.d_na.M_default.C_bzip
spneumo_pangenome_k32	0.0001	eulertigs	21	na	default	xz	791	16611	791	15820	791	791	16611	5028	4760	132	4892	5004	spneumo_pangenome_k32.r_0.0001.S_eulertigs.k_21.d_na.M_default.C_xz
spneumo_pangenome_k32	0.0001	eulertigs	21	na	ones	bzip	791	16611	791	15820	791	791	16611	5028	4760	47	4807	5004	spneumo_pangenome_k32.r_0.0001.S_eulertigs.k_21.d_na.M_ones.C_bzip
spneumo_pangenome_k32	0.0001	eulertigs	21	na	ones	xz	791	16611	791	15820	791	791	16611	5028	4760	132	4892	5004	spneumo_pangenome_k32.r_0.0001.S_eulertigs.k_21.d_na.M_ones.C_xz
spneumo_pangenome_k32	0.0001	eulertigs	21	na	runsapprox	bzip	791	16611	791	15820	791	791	16611	5028	4760	47	4807	5004	spneumo_pangenome_k32.r_0.0001.S_eulertigs.k_21.d_na.M_runsapprox.C_bzip
spneumo_pangenome_k32	0.0001	eulertigs	21	na	runsapprox	xz	791	16611	791	15820	791	791	16611	5028	4760	132	4892	5004	spneumo_pangenome_k32.r_0.0001.S_eulertigs.k_21.d_na.M_runsapprox.C_xz
spneumo_pangenome_k32	0.001	eulertigs	21	na	default	bzip	7910	165970	7910	158060	7903	7903	165970	47500	44124	63	44187	47292	spneumo_pangenome_k32.r_0.001.S_eulertigs.k_21.d_na.M_default.C_bzip
spneumo_pangenome_k32	0.001	eulertigs	21	na	default	xz	7910	165970	7910	158060	7903	7903	165970	47500	44124	200	44324	47292	spneumo_pangenome_k32.r_0.001.S_eulertigs.k_21.d_na.M_default.C_xz
spneumo_pangenome_k32	0.001	eulertigs	21	na	ones	bzip	7910	165970	7911	158059	7904	7903	165970	47500	44124	70	44194	47288	spneumo_pangenome_k32.r_0.001.S_eulertigs.k_21.d_na.M_ones.C_bzip
spneumo_pangenome_k32	0.001	eulertigs	21	na	ones	xz	7910	165970	7911	158059	7904	7903	165970	47500	44124	208	44332	47288	spneumo_pangenome_k32.r_0.001.S_eulertigs.k_21.d_na.M_ones.C_xz
spneumo_pangenome_k32	0.001	eulertigs	21	na	runsapprox	bzip	7910	165970	7911	158059	7904	7903	165970	47500	44124	70	44194	47288	spneumo_pangenome_k32.r_0.001.S_eulertigs.k_21.d_na.M_runsapprox.C_bzip
spneumo_pangenome_k32	0.001	eulertigs	21	na	runsapprox	xz	7910	165970	7911	158059	7904	7903	165970	47500	44124	208	44332	47288	spneumo_pangenome_k32.r_0.001.S_eulertigs.k_21.d_na.M_runsapprox.C_xz
spneumo_pangenome_k32	0.01	eulertigs	21	na	default	bzip	79100	1643740	79100	1564640	78232	78232	1643740	469612	425840	1523	427363	476160	spneumo_pangenome_k32.r_0.01.S_eulertigs.k_21.d_na.M_default.C_bzip
spneumo_pangenome_k32	0.01	eulertigs	21	na	default	xz	79100	1643740	79100	1564640	78232	78232	1643740	469612	425840	2680	428520	476160	spneumo_pangenome_k32.r_0.01.S_eulertigs.k_21.d_na.M_default.C_xz
spneumo_pangenome_k32	0.01	eulertigs	21	na	ones	bzip	79100	1643740	79257	1564483	78388	78232	1643740	469612	425840	1871	427711	476232	spneumo_pangenome_k32.r_0.01.S_eulertigs.k_21.d_na.M_ones.C_bzip
spneumo_pangenome_k32	0.01	eulertigs	21	na	ones	xz	79100	1643740	79257	1564483	78388	78232	1643740	469612	425840	3436	429276	476232	spneumo_pangenome_k32.r_0.01.S_eulertigs.k_21.d_na.M_ones.C_xz
spneumo_pangenome_k32	0.01	eulertigs	21	na	runsapprox	bzip	79100	1643740	79257	1564483	78388	78232	1643740	469612	425840	1871	427711	476232	spneumo_pangenome_k32.r_0.01.S_eulertigs.k_21.d_na.M_runsapprox.C_bzip
spneumo_pangenome_k32	0.01	eulertigs	21	na	runsapprox	xz	79100	1643740	79257	1564483	78388	78232	1643740	469612	425840	3436	429276	476232	spneumo_pangenome_k32.r_0.01.S_eulertigs.k_21.d_na.M_runsapprox.C_xz
spneumo_pangenome_k32	0.05	eulertigs	21	na	default	bzip	395503	7897143	395503	7501640	375082	375082	7897143	2212992	1977816	24058	2001874	2261520	spneumo_pangenome_k32.r_0.05.S_eulertigs.k_21.d_na.M_default.C_bzip
spneumo_pangenome_k32	0.05	eulertigs	21	na	default	xz	395503	7897143	395503	7501640	375082	375082	7897143	2212992	1977816	37592	2015408	2261520	spneumo_pangenome_k32.r_0.05.S_eulertigs.k_21.d_na.M_default.C_xz
spneumo_pangenome_k32	0.05	eulertigs	21	na	ones	bzip	395503	7897143	399489	7497654	378989	375082	7897143	2212992	1977816	30506	2008322	2265144	spneumo_pangenome_k32.r_0.05.S_eulertigs.k_21.d_na.M_ones.C_bzip
spneumo_pangenome_k32	0.05	eulertigs	21	na	ones	xz	395503	7897143	399489	7497654	378989	375082	7897143	2212992	1977816	51988	2029804	2265144	spneumo_pangenome_k32.r_0.05.S_eulertigs.k_21.d_na.M_ones.C_xz
spneumo_pangenome_k32	0.05	eulertigs	21	na	runsapprox	bzip	395503	7897143	399489	7497654	378989	375082	7897143	2212992	1977816	30506	2008322	2265144	spneumo_pangenome_k32.r_0.05.S_eulertigs.k_21.d_na.M_runsapprox.C_bzip
spneumo_pangenome_k32	0.05	eulertigs	21	na	runsapprox	xz	395503	7897143	399489	7497654	378989	375082	7897143	2212992	1977816	51988	2029804	2265144	spneumo_pangenome_k32.r_0.05.S_eulertigs.k_21.d_na.M_runsapprox.C_xz
spneumo_pangenome_k32	0.1	eulertigs	21	na	default	bzip	791006	14992306	791006	14201300	710065	710065	14992306	4139788	3694124	72511	3766635	4260100	spneumo_pangenome_k32.r_0.1.S_eulertigs.k_21.d_na.M_default.C_bzip
spneumo_pangenome_k32	0.1	eulertigs	21	na	default	xz	791006	14992306	791006	14201300	710065	710065	14992306	4139788	3694124	116560	3810684	4260100	spneumo_pangenome_k32.r_0.1.S_eulertigs.k_21.d_na.M_default.C_xz
spneumo_pangenome_k32	0.1	eulertigs	21	na	ones	bzip	791006	14992306	805924	14186382	724428	710065	14992306	4139788	3694124	94092	3788216	4270056	spneumo_pangenome_k32.r_0.1.S_eulertigs.k_21.d_na.M_ones.C_bzip
spneumo_pangenome_k32	0.1	eulertigs	21	na	ones	xz	791006	14992306	805924	14186382	724428	710065	14992306	4139788	3694124	161092	3855216	4270056	spneumo_pangenome_k32.r_0.1.S_eulertigs.k_21.d_na.M_ones.C_xz
spneumo_pangenome_k32	0.1	eulertigs	21	na	runsapprox	bzip	791006	14992306	805924	14186382	724428	710065	14992306	4139788	3694124	94092	3788216	4270056	spneumo_pangenome_k32.r_0.1.S_eulertigs.k_21.d_na.M_runsapprox.C_bzip
spneumo_pangenome_k32	0.1	eulertigs	21	na	runsapprox	xz	791006	14992306	805924	14186382	724428	710065	14992306	4139788	3694124	161092	3855216	4270056	spneumo_pangenome_k32.r_0.1.S_eulertigs.k_21.d_na.M_runsapprox.C_xz
spneumo_pangenome_k32	0.2	eulertigs	21	na	default	bzip	1582012	26799052	1582012	25217040	1260852	1260852	26799052	7299748	6495108	202072	6697180	7567780	spneumo_pangenome_k32.r_0.2.S_eulertigs.k_21.d_na.M_default.C_bzip
spneumo_pangenome_k32	0.2	eulertigs	21	na	default	xz	1582012	26799052	1582012	25217040	1260852	1260852	26799052	7299748	6495108	339408	6834516	7567780	spneumo_pangenome_k32.r_0.2.S_eulertigs.k_21.d_na.M_default.C_xz
spneumo_pangenome_k32	0.2	eulertigs	21	na	ones	bzip	1582012	26799052	1634899	25164153	1309986	1260852	26799052	7299748	6495108	269455	6764563	7607468	spneumo_pangenome_k32.r_0.2.S_eulertigs.k_21.d_na.M_ones.C_bzip
spneumo_pangenome_k32	0.2	eulertigs	21	na	ones	xz	1582012	26799052	1634899	25164153	1309986	1260852	26799052	7299748	6495108	458204	6953312	7607468	spneumo_pangenome_k32.r_0.2.S_eulertigs.k_21.d_na.M_ones.C_xz
spneumo_pangenome_k32	0.2	eulertigs	21	na	runsapprox	bzip	1582012	26799052	1634899	25164153	1309986	1260852	26799052	7299748	6495108	269455	6764563	7607468	spneumo_pangenome_k32.r_0.2.S_eulertigs.k_21.d_na.M_runsapprox.C_bzip
spneumo_pangenome_k32	0.2	eulertigs	21	na	runsapprox	xz	1582012	26799052	1634899	25164153	1309986	1260852	26799052	7299748	6495108	458204	6953312	7607468	spneumo_pangenome_k32.r_0.2.S_eulertigs.k_21.d_na.M_runsapprox.C_xz
spneumo_pangenome_k32	0.3	eulertigs	21	na	default	bzip	2373018	35438678	2373018	33065660	1653283	1653283	35438678	9545624	8500492	355650	8856142	9983060	spneumo_pangenome_k32.r_0.3.S_eulertigs.k_21.d_na.M_default.C_bzip
spneumo_pangenome_k32	0.3	eulertigs	21	na	default	xz	2373018	35438678	2373018	33065660	1653283	1653283	35438678	9545624	8500492	601744	9102236	9983060	spneumo_pangenome_k32.r_0.3.S_eulertigs.k_21.d_na.M_default.C_xz
spneumo_pangenome_k32	0.3	eulertigs	21	na	ones	bzip	2373018	35438678	2477554	32961124	1746571	1653283	35438678	9545624	8500492	479332	8979824	10075360	spneumo_pangenome_k32.r_0.3.S_eulertigs.k_21.d_na.M_ones.C_bzip
spneumo_pangenome_k32	0.3	eulertigs	21	na	ones	xz	2373018	35438678	2477554	32961124	1746571	1653283	35438678	9545624	8500492	787184	9287676	10075360	spneumo_pangenome_k32.r_0.3.S_eulertigs.k_21.d_na.M_ones.C_xz
spneumo_pangenome_k32	0.3	eulertigs	21	na	runsapprox	bzip	2373018	35438678	2477554	32961124	1746571	1653283	35438678	9545624	8500492	479332	8979824	10075360	spneumo_pangenome_k32.r_0.3.S_eulertigs.k_21.d_na.M_runsapprox.C_bzip
spneumo_pangenome_k32	0.3	eulertigs	21	na	runsapprox	xz	2373018	35438678	2477554	32961124	1746571	1653283	35438678	9545624	8500492	787184	9287676	10075360	spneumo_pangenome_k32.r_0.3.S_eulertigs.k_21.d_na.M_runsapprox.C_xz
spneumo_pangenome_k32	0.4	eulertigs	21	na	default	bzip	3164024	40984704	3164024	37820680	1891034	1891034	40984704	10943628	9770248	510665	10280913	11590012	spneumo_pangenome_k32.r_0.4.S_eulertigs.k_21.d_na.M_default.C_bzip
spneumo_pangenome_k32	0.4	eulertigs	21	na	default	xz	3164024	40984704	3164024	37820680	1891034	1891034	40984704	10943628	9770248	852868	10623116	11590012	spneumo_pangenome_k32.r_0.4.S_eulertigs.k_21.d_na.M_default.C_xz
spneumo_pangenome_k32	0.4	eulertigs	21	na	ones	bzip	3164024	40984704	3326153	37658551	2028907	1891034	40984704	10943628	9770248	694262	10464510	11726676	spneumo_pangenome_k32.r_0.4.S_eulertigs.k_21.d_na.M_ones.C_bzip
spneumo_pangenome_k32	0.4	eulertigs	21	na	ones	xz	3164024	40984704	3326153	37658551	2028907	1891034	40984704	10943628	9770248	1088468	10858716	11726676	spneumo_pangenome_k32.r_0.4.S_eulertigs.k_21.d_na.M_ones.C_xz
spneumo_pangenome_k32	0.4	eulertigs	21	na	runsapprox	bzip	3164024	40984704	3326153	37658551	2028907	1891034	40984704	10943628	9770248	694262	10464510	11726676	spneumo_pangenome_k32.r_0.4.S_eulertigs.k_21.d_na.M_runsapprox.C_bzip
spneumo_pangenome_k32	0.4	eulertigs	21	na	runsapprox	xz	3164024	40984704	3326153	37658551	2028907	1891034	40984704	10943628	9770248	1088468	10858716	11726676	spneumo_pangenome_k32.r_0.4.S_eulertigs.k_21.d_na.M_runsapprox.C_xz
spneumo_pangenome_k32	0.5	eulertigs	21	na	default	bzip	3955030	43468650	3955030	39513620	1975681	1975681	43468650	11538028	10316420	648709	10965129	12376344	spneumo_pangenome_k32.r_0.5.S_eulertigs.k_21.d_na.M_default.C_bzip
spneumo_pangenome_k32	0.5	eulertigs	21	na	default	xz	3955030	43468650	3955030	39513620	1975681	1975681	43468650	11538028	10316420	1053200	11369620	12376344	spneumo_pangenome_k32.r_0.5.S_eulertigs.k_21.d_na.M_default.C_xz
spneumo_pangenome_k32	0.5	eulertigs	21	na	ones	bzip	3955030	43468650	4170002	39298648	2148958	1975681	43468650	11538028	10316420	882272	11198692	12565264	spneumo_pangenome_k32.r_0.5.S_eulertigs.k_21.d_na.M_ones.C_bzip
spneumo_pangenome_k32	0.5	eulertigs	21	na	ones	xz	3955030	43468650	4170002	39298648	2148958	1975681	43468650	11538028	10316420	1316612	11633032	12565264	spneumo_pangenome_k32.r_0.5.S_eulertigs.k_21.d_na.M_ones.C_xz
spneumo_pangenome_k32	0.5	eulertigs	21	na	runsapprox	bzip	3955030	43468650	4170002	39298648	2148958	1975681	43468650	11538028	10316420	882272	11198692	12565264	spneumo_pangenome_k32.r_0.5.S_eulertigs.k_21.d_na.M_runsapprox.C_bzip
spneumo_pangenome_k32	0.5	eulertigs	21	na	runsapprox	xz	3955030	43468650	4170002	39298648	2148958	1975681	43468650	11538028	10316420	1316612	11633032	12565264	spneumo_pangenome_k32.r_0.5.S_eulertigs.k_21.d_na.M_runsapprox.C_xz
spneumo_pangenome_k32	0.6	eulertigs	21	na	default	bzip	4746036	42918056	4746036	38172020	1908601	1908601	42918056	11350524	10155304	747263	10902567	12377048	spneumo_pangenome_k32.r_0.6.S_eulertigs.k_21.d_na.M_default.C_bzip
spneumo_pangenome_k32	0.6	eulertigs	21	na	default	xz	4746036	42918056	4746036	38172020	1908601	1908601	42918056	11350524	10155304	1171240	11326544	12377048	spneumo_pangenome_k32.r_0.6.S_eulertigs.k_21.d_na.M_default.C_xz
spneumo_pangenome_k32	0.6	eulertigs	21	na	ones	bzip	4746036	42918056	5001094	37916962	2100541	1908601	42918056	11350524	10155304	1014828	11170132	12587632	spneumo_pangenome_k32.r_0.6.S_eulertigs.k_21.d_na.M_ones.C_bzip
spneumo_pangenome_k32	0.6	eulertigs	21	na	ones	xz	4746036	42918056	5001094	37916962	2100541	1908601	42918056	11350524	10155304	1442848	11598152	12587632	spneumo_pangenome_k32.r_0.6.S_eulertigs.k_21.d_na.M_ones.C_xz
spneumo_pangenome_k32	0.6	eulertigs	21	na	runsapprox	bzip	4746036	42918056	5001094	37916962	2100541	1908601	42918056	11350524	10155304	1014828	11170132	12587632	spneumo_pangenome_k32.r_0.6.S_eulertigs.k_21.d_na.M_runsapprox.C_bzip
spneumo_pangenome_k32	0.6	eulertigs	21	na	runsapprox	xz	4746036	42918056	5001094	37916962	2100541	1908601	42918056	11350524	10155304	1442848	11598152	12587632	spneumo_pangenome_k32.r_0.6.S_eulertigs.k_21.d_na.M_runsapprox.C_xz
spneumo_pangenome_k32	0.7	eulertigs	21	na	default	bzip	5537042	39373562	5537042	33836520	1691826	1691826	39373562	10372588	9298164	777385	10075549	11536204	spneumo_pangenome_k32.r_0.7.S_eulertigs.k_21.d_na.M_default.C_bzip
spneumo_pangenome_k32	0.7	eulertigs	21	na	default	xz	5537042	39373562	5537042	33836520	1691826	1691826	39373562	10372588	9298164	1175676	10473840	11536204	spneumo_pangenome_k32.r_0.7.S_eulertigs.k_21.d_na.M_default.C_xz
spneumo_pangenome_k32	0.7	eulertigs	21	na	ones	bzip	5537042	39373562	5810279	33563283	1880865	1691826	39373562	10372588	9298164	1053205	10351369	11747524	spneumo_pangenome_k32.r_0.7.S_eulertigs.k_21.d_na.M_ones.C_bzip
spneumo_pangenome_k32	0.7	eulertigs	21	na	ones	xz	5537042	39373562	5810279	33563283	1880865	1691826	39373562	10372588	9298164	1437604	10735768	11747524	spneumo_pangenome_k32.r_0.7.S_eulertigs.k_21.d_na.M_ones.C_xz
spneumo_pangenome_k32	0.7	eulertigs	21	na	runsapprox	bzip	5537042	39373562	5810279	33563283	1880865	1691826	39373562	10372588	9298164	1053205	10351369	11747524	spneumo_pangenome_k32.r_0.7.S_eulertigs.k_21.d_na.M_runsapprox.C_bzip
spneumo_pangenome_k32	0.7	eulertigs	21	na	runsapprox	xz	5537042	39373562	5810279	33563283	1880865	1691826	39373562	10372588	9298164	1437604	10735768	11747524	spneumo_pangenome_k32.r_0.7.S_eulertigs.k_21.d_na.M_runsapprox.C_xz
spneumo_pangenome_k32	0.8	eulertigs	21	na	default	bzip	6328048	32863528	6328048	26535480	1326774	1326774	32863528	8621244	7745076	715388	8460464	9812732	spneumo_pangenome_k32.r_0.8.S_eulertigs.k_21.d_na.M_default.C_bzip
spneumo_pangenome_k32	0.8	eulertigs	21	na	default	xz	6328048	32863528	6328048	26535480	1326774	1326774	32863528	8621244	7745076	1038616	8783692	9812732	spneumo_pangenome_k32.r_0.8.S_eulertigs.k_21.d_na.M_default.C_xz
spneumo_pangenome_k32	0.8	eulertigs	21	na	ones	bzip	6328048	32863528	6590316	26273212	1484982	1326774	32863528	8621244	7745076	964126	8709202	9995588	spneumo_pangenome_k32.r_0.8.S_eulertigs.k_21.d_na.M_ones.C_bzip
spneumo_pangenome_k32	0.8	eulertigs	21	na	ones	xz	6328048	32863528	6590316	26273212	1484982	1326774	32863528	8621244	7745076	1271456	9016532	9995588	spneumo_pangenome_k32.r_0.8.S_eulertigs.k_21.d_na.M_ones.C_xz
spneumo_pangenome_k32	0.8	eulertigs	21	na	runsapprox	bzip	6328048	32863528	6590316	26273212	1484982	1326774	32863528	8621244	7745076	964126	8709202	9995588	spneumo_pangenome_k32.r_0.8.S_eulertigs.k_21.d_na.M_runsapprox.C_bzip
spneumo_pangenome_k32	0.8	eulertigs	21	na	runsapprox	xz	6328048	32863528	6590316	26273212	1484982	1326774	32863528	8621244	7745076	1271456	9016532	9995588	spneumo_pangenome_k32.r_0.8.S_eulertigs.k_21.d_na.M_runsapprox.C_xz
spneumo_pangenome_k32	0.9	eulertigs	21	na	default	bzip	7119054	23421174	7119054	16302120	815106	815106	23421174	6072364	5483980	529129	6013109	7059372	spneumo_pangenome_k32.r_0.9.S_eulertigs.k_21.d_na.M_default.C_bzip
spneumo_pangenome_k32	0.9	eulertigs	21	na	default	xz	7119054	23421174	7119054	16302120	815106	815106	23421174	6072364	5483980	752344	6236324	7059372	spneumo_pangenome_k32.r_0.9.S_eulertigs.k_21.d_na.M_default.C_xz
spneumo_pangenome_k32	0.9	eulertigs	21	na	ones	bzip	7119054	23421174	7333498	16087676	911697	815106	23421174	6072364	5483980	714441	6198421	7187296	spneumo_pangenome_k32.r_0.9.S_eulertigs.k_21.d_na.M_ones.C_bzip
spneumo_pangenome_k32	0.9	eulertigs	21	na	ones	xz	7119054	23421174	7333498	16087676	911697	815106	23421174	6072364	5483980	927600	6411580	7187296	spneumo_pangenome_k32.r_0.9.S_eulertigs.k_21.d_na.M_ones.C_xz
spneumo_pangenome_k32	0.9	eulertigs	21	na	runsapprox	bzip	7119054	23421174	7333498	16087676	911697	815106	23421174	6072364	5483980	714441	6198421	7187296	spneumo_pangenome_k32.r_0.9.S_eulertigs.k_21.d_na.M_runsapprox.C_bzip
spneumo_pangenome_k32	0.9	eulertigs	21	na	runsapprox	xz	7119054	23421174	7333498	16087676	911697	815106	23421174	6072364	5483980	927600	6411580	7187296	spneumo_pangenome_k32.r_0.9.S_eulertigs.k_21.d_na.M_runsapprox.C_xz
spneumo_pangenome_k32	1.0	eulertigs	21	na	default	bzip	7910060	11083480	7910060	3173420	158671	158671	11083480	2615892	2466492	128778	2595270	2987908	spneumo_pangenome_k32.r_1.0.S_eulertigs.k_21.d_na.M_default.C_bzip
spneumo_pangenome_k32	1.0	eulertigs	21	na	default	xz	7910060	11083480	7910060	3173420	158671	158671	11083480	2615892	2466492	216404	2682896	2987908	spneumo_pangenome_k32.r_1.0.S_eulertigs.k_21.d_na.M_default.C_xz
spneumo_pangenome_k32	1.0	eulertigs	21	na	ones	bzip	7910060	11083480	8028897	3054583	158947	158671	11083480	2615892	2466492	174777	2641269	2998072	spneumo_pangenome_k32.r_1.0.S_eulertigs.k_21.d_na.M_ones.C_bzip
spneumo_pangenome_k32	1.0	eulertigs	21	na	ones	xz	7910060	11083480	8028897	3054583	158947	158671	11083480	2615892	2466492	263764	2730256	2998072	spneumo_pangenome_k32.r_1.0.S_eulertigs.k_21.d_na.M_ones.C_xz
spneumo_pangenome_k32	1.0	eulertigs	21	na	runsapprox	bzip	7910060	11083480	8028897	3054583	158947	158671	11083480	2615892	2466492	174777	2641269	2998072	spneumo_pangenome_k32.r_1.0.S_eulertigs.k_21.d_na.M_runsapprox.C_bzip
spneumo_pangenome_k32	1.0	eulertigs	21	na	runsapprox	xz	7910060	11083480	8028897	3054583	158947	158671	11083480	2615892	2466492	263764	2730256	2998072	spneumo_pangenome_k32.r_1.0.S_eulertigs.k_21.d_na.M_runsapprox.C_xz
spneumo_pangenome_k32	0.000000001	greedytigs	21	na	default	bzip	1	21	1	20	1	1	21	88	88	41	129	88	spneumo_pangenome_k32.r_0.000000001.S_greedytigs.k_21.d_na.M_default.C_bzip
spneumo_pangenome_k32	0.000000001	greedytigs	21	na	default	xz	1	21	1	20	1	1	21	88	88	76	164	88	spneumo_pangenome_k32.r_0.000000001.S_greedytigs.k_21.d_na.M_default.C_xz
spneumo_pangenome_k32	0.000000001	greedytigs	21	na	ones	bzip	1	21	1	20	1	1	21	88	88	41	129	88	spneumo_pangenome_k32.r_0.000000001.S_greedytigs.k_21.d_na.M_ones.C_bzip
spneumo_pangenome_k32	0.000000001	greedytigs	21	na	ones	xz	1	21	1	20	1	1	21	88	88	76	164	88	spneumo_pangenome_k32.r_0.000000001.S_greedytigs.k_21.d_na.M_ones.C_xz
spneumo_pangenome_k32	0.000000001	greedytigs	21	na	runsapprox	bzip	1	21	1	20	1	1	21	88	88	41	129	88	spneumo_pangenome_k32.r_0.000000001.S_greedytigs.k_21.d_na.M_runsapprox.C_bzip
spneumo_pangenome_k32	0.000000001	greedytigs	21	na	runsapprox	xz	1	21	1	20	1	1	21	88	88	76	164	88	spneumo_pangenome_k32.r_0.000000001.S_greedytigs.k_21.d_na.M_runsapprox.C_xz
spneumo_pangenome_k32	0.0001	greedytigs	21	na	default	bzip	791	16611	791	15820	791	791	16611	5028	4760	47	4807	5004	spneumo_pangenome_k32.r_0.0001.S_greedytigs.k_21.d_na.M_default.C_bzip
spneumo_pangenome_k32	0.0001	greedytigs	21	na	default	xz	791	16611	791	15820	791	791	16611	5028	4760	132	4892	5004	spneumo_pangenome_k32.r_0.0001.S_greedytigs.k_21.d_na.M_default.C_xz
spneumo_pangenome_k32	0.0001	greedytigs	21	na	ones	bzip	791	16611	791	15820	791	791	16611	5028	4760	47	4807	5004	spneumo_pangenome_k32.r_0.0001.S_greedytigs.k_21.d_na.M_ones.C_bzip
spneumo_pangenome_k32	0.0001	greedytigs	21	na	ones	xz	791	16611	791	15820	791	791	16611	5028	4760	132	4892	5004	spneumo_pangenome_k32.r_0.0001.S_greedytigs.k_21.d_na.M_ones.C_xz
spneumo_pangenome_k32	0.0001	greedytigs	21	na	runsapprox	bzip	791	16611	791	15820	791	791	16611	5028	4760	47	4807	5004	spneumo_pangenome_k32.r_0.0001.S_greedytigs.k_21.d_na.M_runsapprox.C_bzip
spneumo_pangenome_k32	0.0001	greedytigs	21	na	runsapprox	xz	791	16611	791	15820	791	791	16611	5028	4760	132	4892	5004	spneumo_pangenome_k32.r_0.0001.S_greedytigs.k_21.d_na.M_runsapprox.C_xz
spneumo_pangenome_k32	0.001	greedytigs	21	na	default	bzip	7910	165970	7910	158060	7903	7903	165970	47500	44124	63	44187	47292	spneumo_pangenome_k32.r_0.001.S_greedytigs.k_21.d_na.M_default.C_bzip
spneumo_pangenome_k32	0.001	greedytigs	21	na	default	xz	7910	165970	7910	158060	7903	7903	165970	47500	44124	200	44324	47292	spneumo_pangenome_k32.r_0.001.S_greedytigs.k_21.d_na.M_default.C_xz
spneumo_pangenome_k32	0.001	greedytigs	21	na	ones	bzip	7910	165970	7911	158059	7904	7903	165970	47500	44124	70	44194	47288	spneumo_pangenome_k32.r_0.001.S_greedytigs.k_21.d_na.M_ones.C_bzip
spneumo_pangenome_k32	0.001	greedytigs	21	na	ones	xz	7910	165970	7911	158059	7904	7903	165970	47500	44124	208	44332	47288	spneumo_pangenome_k32.r_0.001.S_greedytigs.k_21.d_na.M_ones.C_xz
spneumo_pangenome_k32	0.001	greedytigs	21	na	runsapprox	bzip	7910	165970	7911	158059	7904	7903	165970	47500	44124	70	44194	47288	spneumo_pangenome_k32.r_0.001.S_greedytigs.k_21.d_na.M_runsapprox.C_bzip
spneumo_pangenome_k32	0.001	greedytigs	21	na	runsapprox	xz	7910	165970	7911	158059	7904	7903	165970	47500	44124	208	44332	47288	spneumo_pangenome_k32.r_0.001.S_greedytigs.k_21.d_na.M_runsapprox.C_xz
spneumo_pangenome_k32	0.01	greedytigs	21	na	default	bzip	79100	1643740	79100	1564640	78232	78232	1643740	469612	425840	1523	427363	476160	spneumo_pangenome_k32.r_0.01.S_greedytigs.k_21.d_na.M_default.C_bzip
spneumo_pangenome_k32	0.01	greedytigs	21	na	default	xz	79100	1643740	79100	1564640	78232	78232	1643740	469612	425840	2680	428520	476160	spneumo_pangenome_k32.r_0.01.S_greedytigs.k_21.d_na.M_default.C_xz
spneumo_pangenome_k32	0.01	greedytigs	21	na	ones	bzip	79100	1643740	79257	1564483	78388	78232	1643740	469612	425840	1871	427711	476232	spneumo_pangenome_k32.r_0.01.S_greedytigs.k_21.d_na.M_ones.C_bzip
spneumo_pangenome_k32	0.01	greedytigs	21	na	ones	xz	79100	1643740	79257	1564483	78388	78232	1643740	469612	425840	3436	429276	476232	spneumo_pangenome_k32.r_0.01.S_greedytigs.k_21.d_na.M_ones.C_xz
spneumo_pangenome_k32	0.01	greedytigs	21	na	runsapprox	bzip	79100	1643740	79257	1564483	78388	78232	1643740	469612	425840	1871	427711	476232	spneumo_pangenome_k32.r_0.01.S_greedytigs.k_21.d_na.M_runsapprox.C_bzip
spneumo_pangenome_k32	0.01	greedytigs	21	na	runsapprox	xz	79100	1643740	79257	1564483	78388	78232	1643740	469612	425840	3436	429276	476232	spneumo_pangenome_k32.r_0.01.S_greedytigs.k_21.d_na.M_runsapprox.C_xz
spneumo_pangenome_k32	0.05	greedytigs	21	na	default	bzip	395503	7897143	395503	7501640	375082	375082	7897143	2212992	1977816	24058	2001874	2261520	spneumo_pangenome_k32.r_0.05.S_greedytigs.k_21.d_na.M_default.C_bzip
spneumo_pangenome_k32	0.05	greedytigs	21	na	default	xz	395503	7897143	395503	7501640	375082	375082	7897143	2212992	1977816	37592	2015408	2261520	spneumo_pangenome_k32.r_0.05.S_greedytigs.k_21.d_na.M_default.C_xz
spneumo_pangenome_k32	0.05	greedytigs	21	na	ones	bzip	395503	7897143	399489	7497654	378989	375082	7897143	2212992	1977816	30506	2008322	2265144	spneumo_pangenome_k32.r_0.05.S_greedytigs.k_21.d_na.M_ones.C_bzip
spneumo_pangenome_k32	0.05	greedytigs	21	na	ones	xz	395503	7897143	399489	7497654	378989	375082	7897143	2212992	1977816	51988	2029804	2265144	spneumo_pangenome_k32.r_0.05.S_greedytigs.k_21.d_na.M_ones.C_xz
spneumo_pangenome_k32	0.05	greedytigs	21	na	runsapprox	bzip	395503	7897143	399489	7497654	378989	375082	7897143	2212992	1977816	30506	2008322	2265144	spneumo_pangenome_k32.r_0.05.S_greedytigs.k_21.d_na.M_runsapprox.C_bzip
spneumo_pangenome_k32	0.05	greedytigs	21	na	runsapprox	xz	395503	7897143	399489	7497654	378989	375082	7897143	2212992	1977816	51988	2029804	2265144	spneumo_pangenome_k32.r_0.05.S_greedytigs.k_21.d_na.M_runsapprox.C_xz
spneumo_pangenome_k32	0.1	greedytigs	21	na	default	bzip	791006	14992306	791006	14201300	710065	710065	14992306	4139788	3694124	72511	3766635	4260100	spneumo_pangenome_k32.r_0.1.S_greedytigs.k_21.d_na.M_default.C_bzip
spneumo_pangenome_k32	0.1	greedytigs	21	na	default	xz	791006	14992306	791006	14201300	710065	710065	14992306	4139788	3694124	116560	3810684	4260100	spneumo_pangenome_k32.r_0.1.S_greedytigs.k_21.d_na.M_default.C_xz
spneumo_pangenome_k32	0.1	greedytigs	21	na	ones	bzip	791006	14992306	805924	14186382	724428	710065	14992306	4139788	3694124	94092	3788216	4270056	spneumo_pangenome_k32.r_0.1.S_greedytigs.k_21.d_na.M_ones.C_bzip
spneumo_pangenome_k32	0.1	greedytigs	21	na	ones	xz	791006	14992306	805924	14186382	724428	710065	14992306	4139788	3694124	161092	3855216	4270056	spneumo_pangenome_k32.r_0.1.S_greedytigs.k_21.d_na.M_ones.C_xz
spneumo_pangenome_k32	0.1	greedytigs	21	na	runsapprox	bzip	791006	14992306	805924	14186382	724428	710065	14992306	4139788	3694124	94092	3788216	4270056	spneumo_pangenome_k32.r_0.1.S_greedytigs.k_21.d_na.M_runsapprox.C_bzip
spneumo_pangenome_k32	0.1	greedytigs	21	na	runsapprox	xz	791006	14992306	805924	14186382	724428	710065	14992306	4139788	3694124	161092	3855216	4270056	spneumo_pangenome_k32.r_0.1.S_greedytigs.k_21.d_na.M_runsapprox.C_xz
spneumo_pangenome_k32	0.2	greedytigs	21	na	default	bzip	1582012	26798884	1582024	25216860	1260843	1260843	26798884	7298728	6495112	202241	6697353	7588236	spneumo_pangenome_k32.r_0.2.S_greedytigs.k_21.d_na.M_default.C_bzip
spneumo_pangenome_k32	0.2	greedytigs	21	na	default	xz	1582012	26798884	1582024	25216860	1260843	1260843	26798884	7298728	6495112	339288	6834400	7588236	spneumo_pangenome_k32.r_0.2.S_greedytigs.k_21.d_na.M_default.C_xz
spneumo_pangenome_k32	0.2	greedytigs	21	na	ones	bzip	1582012	26798884	1634696	25164188	1309804	1260843	26798884	7298728	6495112	269250	6764362	7623256	spneumo_pangenome_k32.r_0.2.S_greedytigs.k_21.d_na.M_ones.C_bzip
spneumo_pangenome_k32	0.2	greedytigs	21	na	ones	xz	1582012	26798884	1634696	25164188	1309804	1260843	26798884	7298728	6495112	457848	6952960	7623256	spneumo_pangenome_k32.r_0.2.S_greedytigs.k_21.d_na.M_ones.C_xz
spneumo_pangenome_k32	0.2	greedytigs	21	na	runsapprox	bzip	1582012	26798884	1634696	25164188	1309804	1260843	26798884	7298728	6495112	269250	6764362	7623256	spneumo_pangenome_k32.r_0.2.S_greedytigs.k_21.d_na.M_runsapprox.C_bzip
spneumo_pangenome_k32	0.2	greedytigs	21	na	runsapprox	xz	1582012	26798884	1634696	25164188	1309804	1260843	26798884	7298728	6495112	457848	6952960	7623256	spneumo_pangenome_k32.r_0.2.S_greedytigs.k_21.d_na.M_runsapprox.C_xz
spneumo_pangenome_k32	0.3	greedytigs	21	na	default	bzip	2373018	35437572	2373112	33064460	1653223	1653223	35437572	9544756	8500340	355714	8856054	9989196	spneumo_pangenome_k32.r_0.3.S_greedytigs.k_21.d_na.M_default.C_bzip
spneumo_pangenome_k32	0.3	greedytigs	21	na	default	xz	2373018	35437572	2373112	33064460	1653223	1653223	35437572	9544756	8500340	601732	9102072	9989196	spneumo_pangenome_k32.r_0.3.S_greedytigs.k_21.d_na.M_default.C_xz
spneumo_pangenome_k32	0.3	greedytigs	21	na	ones	bzip	2373018	35437572	2477789	32959783	1746474	1653223	35437572	9544756	8500340	479523	8979863	10073384	spneumo_pangenome_k32.r_0.3.S_greedytigs.k_21.d_na.M_ones.C_bzip
spneumo_pangenome_k32	0.3	greedytigs	21	na	ones	xz	2373018	35437572	2477789	32959783	1746474	1653223	35437572	9544756	8500340	787284	9287624	10073384	spneumo_pangenome_k32.r_0.3.S_greedytigs.k_21.d_na.M_ones.C_xz
spneumo_pangenome_k32	0.3	greedytigs	21	na	runsapprox	bzip	2373018	35437572	2477789	32959783	1746474	1653223	35437572	9544756	8500340	479523	8979863	10073384	spneumo_pangenome_k32.r_0.3.S_greedytigs.k_21.d_na.M_runsapprox.C_bzip
spneumo_pangenome_k32	0.3	greedytigs	21	na	runsapprox	xz	2373018	35437572	2477789	32959783	1746474	1653223	35437572	9544756	8500340	787284	9287624	10073384	spneumo_pangenome_k32.r_0.3.S_greedytigs.k_21.d_na.M_runsapprox.C_xz
spneumo_pangenome_k32	0.4	greedytigs	21	na	default	bzip	3164024	40980542	3164422	37816120	1890806	1890806	40980542	10945908	9766356	510719	10277075	11582684	spneumo_pangenome_k32.r_0.4.S_greedytigs.k_21.d_na.M_default.C_bzip
spneumo_pangenome_k32	0.4	greedytigs	21	na	default	xz	3164024	40980542	3164422	37816120	1890806	1890806	40980542	10945908	9766356	852856	10619212	11582684	spneumo_pangenome_k32.r_0.4.S_greedytigs.k_21.d_na.M_default.C_xz
spneumo_pangenome_k32	0.4	greedytigs	21	na	ones	bzip	3164024	40980542	3325654	37654888	2027978	1890806	40980542	10945908	9766356	693091	10459447	11722200	spneumo_pangenome_k32.r_0.4.S_greedytigs.k_21.d_na.M_ones.C_bzip
spneumo_pangenome_k32	0.4	greedytigs	21	na	ones	xz	3164024	40980542	3325654	37654888	2027978	1890806	40980542	10945908	9766356	1086204	10852560	11722200	spneumo_pangenome_k32.r_0.4.S_greedytigs.k_21.d_na.M_ones.C_xz
spneumo_pangenome_k32	0.4	greedytigs	21	na	runsapprox	bzip	3164024	40980542	3325654	37654888	2027978	1890806	40980542	10945908	9766356	693091	10459447	11722200	spneumo_pangenome_k32.r_0.4.S_greedytigs.k_21.d_na.M_runsapprox.C_bzip
spneumo_pangenome_k32	0.4	greedytigs	21	na	runsapprox	xz	3164024	40980542	3325654	37654888	2027978	1890806	40980542	10945908	9766356	1086204	10852560	11722200	spneumo_pangenome_k32.r_0.4.S_greedytigs.k_21.d_na.M_runsapprox.C_xz
spneumo_pangenome_k32	0.5	greedytigs	21	na	default	bzip	3955030	43455744	3956524	39499220	1974961	1974961	43455744	11534136	10313384	648987	10962371	12373464	spneumo_pangenome_k32.r_0.5.S_greedytigs.k_21.d_na.M_default.C_bzip
spneumo_pangenome_k32	0.5	greedytigs	21	na	default	xz	3955030	43455744	3956524	39499220	1974961	1974961	43455744	11534136	10313384	1053464	11366848	12373464	spneumo_pangenome_k32.r_0.5.S_greedytigs.k_21.d_na.M_default.C_xz
spneumo_pangenome_k32	0.5	greedytigs	21	na	ones	bzip	3955030	43455744	4170443	39285301	2147774	1974961	43455744	11534136	10313384	881136	11194520	12562492	spneumo_pangenome_k32.r_0.5.S_greedytigs.k_21.d_na.M_ones.C_bzip
spneumo_pangenome_k32	0.5	greedytigs	21	na	ones	xz	3955030	43455744	4170443	39285301	2147774	1974961	43455744	11534136	10313384	1316328	11629712	12562492	spneumo_pangenome_k32.r_0.5.S_greedytigs.k_21.d_na.M_ones.C_xz
spneumo_pangenome_k32	0.5	greedytigs	21	na	runsapprox	bzip	3955030	43455744	4170443	39285301	2147774	1974961	43455744	11534136	10313384	881136	11194520	12562492	spneumo_pangenome_k32.r_0.5.S_greedytigs.k_21.d_na.M_runsapprox.C_bzip
spneumo_pangenome_k32	0.5	greedytigs	21	na	runsapprox	xz	3955030	43455744	4170443	39285301	2147774	1974961	43455744	11534136	10313384	1316328	11629712	12562492	spneumo_pangenome_k32.r_0.5.S_greedytigs.k_21.d_na.M_runsapprox.C_xz
spneumo_pangenome_k32	0.6	greedytigs	21	na	default	bzip	4746036	42883903	4750983	38132920	1906646	1906646	42883903	11348872	10158680	747518	10906198	12372556	spneumo_pangenome_k32.r_0.6.S_greedytigs.k_21.d_na.M_default.C_bzip
spneumo_pangenome_k32	0.6	greedytigs	21	na	default	xz	4746036	42883903	4750983	38132920	1906646	1906646	42883903	11348872	10158680	1171196	11329876	12372556	spneumo_pangenome_k32.r_0.6.S_greedytigs.k_21.d_na.M_default.C_xz
spneumo_pangenome_k32	0.6	greedytigs	21	na	ones	bzip	4746036	42883903	5005169	37878734	2099398	1906646	42883903	11348872	10158680	1014301	11172981	12588928	spneumo_pangenome_k32.r_0.6.S_greedytigs.k_21.d_na.M_ones.C_bzip
spneumo_pangenome_k32	0.6	greedytigs	21	na	ones	xz	4746036	42883903	5005169	37878734	2099398	1906646	42883903	11348872	10158680	1442768	11601448	12588928	spneumo_pangenome_k32.r_0.6.S_greedytigs.k_21.d_na.M_ones.C_xz
spneumo_pangenome_k32	0.6	greedytigs	21	na	runsapprox	bzip	4746036	42883903	5005169	37878734	2099398	1906646	42883903	11348872	10158680	1014301	11172981	12588928	spneumo_pangenome_k32.r_0.6.S_greedytigs.k_21.d_na.M_runsapprox.C_bzip
spneumo_pangenome_k32	0.6	greedytigs	21	na	runsapprox	xz	4746036	42883903	5005169	37878734	2099398	1906646	42883903	11348872	10158680	1442768	11601448	12588928	spneumo_pangenome_k32.r_0.6.S_greedytigs.k_21.d_na.M_runsapprox.C_xz
spneumo_pangenome_k32	0.7	greedytigs	21	na	default	bzip	5537042	39290169	5553269	33736900	1686845	1686845	39290169	10353536	9283616	778067	10061683	11519320	spneumo_pangenome_k32.r_0.7.S_greedytigs.k_21.d_na.M_default.C_bzip
spneumo_pangenome_k32	0.7	greedytigs	21	na	default	xz	5537042	39290169	5553269	33736900	1686845	1686845	39290169	10353536	9283616	1175112	10458728	11519320	spneumo_pangenome_k32.r_0.7.S_greedytigs.k_21.d_na.M_default.C_xz
spneumo_pangenome_k32	0.7	greedytigs	21	na	ones	bzip	5537042	39290169	5822502	33467667	1875803	1686845	39290169	10353536	9283616	1050273	10333889	11729276	spneumo_pangenome_k32.r_0.7.S_greedytigs.k_21.d_na.M_ones.C_bzip
spneumo_pangenome_k32	0.7	greedytigs	21	na	ones	xz	5537042	39290169	5822502	33467667	1875803	1686845	39290169	10353536	9283616	1434088	10717704	11729276	spneumo_pangenome_k32.r_0.7.S_greedytigs.k_21.d_na.M_ones.C_xz
spneumo_pangenome_k32	0.7	greedytigs	21	na	runsapprox	bzip	5537042	39290169	5822502	33467667	1875803	1686845	39290169	10353536	9283616	1050273	10333889	11729276	spneumo_pangenome_k32.r_0.7.S_greedytigs.k_21.d_na.M_runsapprox.C_bzip
spneumo_pangenome_k32	0.7	greedytigs	21	na	runsapprox	xz	5537042	39290169	5822502	33467667	1875803	1686845	39290169	10353536	9283616	1434088	10717704	11729276	spneumo_pangenome_k32.r_0.7.S_greedytigs.k_21.d_na.M_runsapprox.C_xz
spneumo_pangenome_k32	0.8	greedytigs	21	na	default	bzip	6328048	32671362	6381922	26289440	1314472	1314472	32671362	8578132	7711220	713392	8424612	9766144	spneumo_pangenome_k32.r_0.8.S_greedytigs.k_21.d_na.M_default.C_bzip
spneumo_pangenome_k32	0.8	greedytigs	21	na	default	xz	6328048	32671362	6381922	26289440	1314472	1314472	32671362	8578132	7711220	1033460	8744680	9766144	spneumo_pangenome_k32.r_0.8.S_greedytigs.k_21.d_na.M_default.C_xz
spneumo_pangenome_k32	0.8	greedytigs	21	na	ones	bzip	6328048	32671362	6635405	26035957	1473084	1314472	32671362	8578132	7711220	955278	8666498	9945120	spneumo_pangenome_k32.r_0.8.S_greedytigs.k_21.d_na.M_ones.C_bzip
spneumo_pangenome_k32	0.8	greedytigs	21	na	ones	xz	6328048	32671362	6635405	26035957	1473084	1314472	32671362	8578132	7711220	1262736	8973956	9945120	spneumo_pangenome_k32.r_0.8.S_greedytigs.k_21.d_na.M_ones.C_xz
spneumo_pangenome_k32	0.8	greedytigs	21	na	runsapprox	bzip	6328048	32671362	6635405	26035957	1473084	1314472	32671362	8578132	7711220	955278	8666498	9945120	spneumo_pangenome_k32.r_0.8.S_greedytigs.k_21.d_na.M_runsapprox.C_bzip
spneumo_pangenome_k32	0.8	greedytigs	21	na	runsapprox	xz	6328048	32671362	6635405	26035957	1473084	1314472	32671362	8578132	7711220	1262736	8973956	9945120	spneumo_pangenome_k32.r_0.8.S_greedytigs.k_21.d_na.M_runsapprox.C_xz
spneumo_pangenome_k32	0.9	greedytigs	21	na	default	bzip	7119054	23001913	7312893	15689020	784451	784451	23001913	5944756	5381868	522062	5903930	6938712	spneumo_pangenome_k32.r_0.9.S_greedytigs.k_21.d_na.M_default.C_bzip
spneumo_pangenome_k32	0.9	greedytigs	21	na	default	xz	7119054	23001913	7312893	15689020	784451	784451	23001913	5944756	5381868	738808	6120676	6938712	spneumo_pangenome_k32.r_0.9.S_greedytigs.k_21.d_na.M_default.C_xz
spneumo_pangenome_k32	0.9	greedytigs	21	na	ones	bzip	7119054	23001913	7503967	15497946	881099	784451	23001913	5944756	5381868	689551	6071419	7052700	spneumo_pangenome_k32.r_0.9.S_greedytigs.k_21.d_na.M_ones.C_bzip
spneumo_pangenome_k32	0.9	greedytigs	21	na	ones	xz	7119054	23001913	7503967	15497946	881099	784451	23001913	5944756	5381868	902864	6284732	7052700	spneumo_pangenome_k32.r_0.9.S_greedytigs.k_21.d_na.M_ones.C_xz
spneumo_pangenome_k32	0.9	greedytigs	21	na	runsapprox	bzip	7119054	23001913	7503967	15497946	881099	784451	23001913	5944756	5381868	689551	6071419	7052700	spneumo_pangenome_k32.r_0.9.S_greedytigs.k_21.d_na.M_runsapprox.C_bzip
spneumo_pangenome_k32	0.9	greedytigs	21	na	runsapprox	xz	7119054	23001913	7503967	15497946	881099	784451	23001913	5944756	5381868	902864	6284732	7052700	spneumo_pangenome_k32.r_0.9.S_greedytigs.k_21.d_na.M_runsapprox.C_xz
spneumo_pangenome_k32	1.0	greedytigs	21	na	default	bzip	7910060	10193078	8691218	1501860	75093	75093	10193078	2143968	2074740	78388	2153128	2413672	spneumo_pangenome_k32.r_1.0.S_greedytigs.k_21.d_na.M_default.C_bzip
spneumo_pangenome_k32	1.0	greedytigs	21	na	default	xz	7910060	10193078	8691218	1501860	75093	75093	10193078	2143968	2074740	149780	2224520	2413672	spneumo_pangenome_k32.r_1.0.S_greedytigs.k_21.d_na.M_default.C_xz
spneumo_pangenome_k32	1.0	greedytigs	21	na	ones	bzip	7910060	10193078	8745675	1447403	75178	75093	10193078	2143968	2074740	98110	2172850	2411524	spneumo_pangenome_k32.r_1.0.S_greedytigs.k_21.d_na.M_ones.C_bzip
spneumo_pangenome_k32	1.0	greedytigs	21	na	ones	xz	7910060	10193078	8745675	1447403	75178	75093	10193078	2143968	2074740	170056	2244796	2411524	spneumo_pangenome_k32.r_1.0.S_greedytigs.k_21.d_na.M_ones.C_xz
spneumo_pangenome_k32	1.0	greedytigs	21	na	runsapprox	bzip	7910060	10193078	8745543	1447535	75092	75093	10193078	2143968	2074740	97875	2172615	2411724	spneumo_pangenome_k32.r_1.0.S_greedytigs.k_21.d_na.M_runsapprox.C_bzip
spneumo_pangenome_k32	1.0	greedytigs	21	na	runsapprox	xz	7910060	10193078	8745543	1447535	75092	75093	10193078	2143968	2074740	169800	2244540	2411724	spneumo_pangenome_k32.r_1.0.S_greedytigs.k_21.d_na.M_runsapprox.C_xz
spneumo_pangenome_k32	0.000000001	prophasm	21	na	default	bzip	1	21	1	20	1	1	21	88	88	41	129	88	spneumo_pangenome_k32.r_0.000000001.S_prophasm.k_21.d_na.M_default.C_bzip
spneumo_pangenome_k32	0.000000001	prophasm	21	na	default	xz	1	21	1	20	1	1	21	88	88	76	164	88	spneumo_pangenome_k32.r_0.000000001.S_prophasm.k_21.d_na.M_default.C_xz
spneumo_pangenome_k32	0.000000001	prophasm	21	na	ones	bzip	1	21	1	20	1	1	21	88	88	41	129	88	spneumo_pangenome_k32.r_0.000000001.S_prophasm.k_21.d_na.M_ones.C_bzip
spneumo_pangenome_k32	0.000000001	prophasm	21	na	ones	xz	1	21	1	20	1	1	21	88	88	76	164	88	spneumo_pangenome_k32.r_0.000000001.S_prophasm.k_21.d_na.M_ones.C_xz
spneumo_pangenome_k32	0.000000001	prophasm	21	na	runsapprox	bzip	1	21	1	20	1	1	21	88	88	41	129	88	spneumo_pangenome_k32.r_0.000000001.S_prophasm.k_21.d_na.M_runsapprox.C_bzip
spneumo_pangenome_k32	0.000000001	prophasm	21	na	runsapprox	xz	1	21	1	20	1	1	21	88	88	76	164	88	spneumo_pangenome_k32.r_0.000000001.S_prophasm.k_21.d_na.M_runsapprox.C_xz
spneumo_pangenome_k32	0.0001	prophasm	21	na	default	bzip	791	16611	791	15820	791	791	16611	5468	4880	47	4927	5552	spneumo_pangenome_k32.r_0.0001.S_prophasm.k_21.d_na.M_default.C_bzip
spneumo_pangenome_k32	0.0001	prophasm	21	na	default	xz	791	16611	791	15820	791	791	16611	5468	4880	132	5012	5552	spneumo_pangenome_k32.r_0.0001.S_prophasm.k_21.d_na.M_default.C_xz
spneumo_pangenome_k32	0.0001	prophasm	21	na	ones	bzip	791	16611	791	15820	791	791	16611	5468	4880	47	4927	5552	spneumo_pangenome_k32.r_0.0001.S_prophasm.k_21.d_na.M_ones.C_bzip
spneumo_pangenome_k32	0.0001	prophasm	21	na	ones	xz	791	16611	791	15820	791	791	16611	5468	4880	132	5012	5552	spneumo_pangenome_k32.r_0.0001.S_prophasm.k_21.d_na.M_ones.C_xz
spneumo_pangenome_k32	0.0001	prophasm	21	na	runsapprox	bzip	791	16611	791	15820	791	791	16611	5468	4880	47	4927	5552	spneumo_pangenome_k32.r_0.0001.S_prophasm.k_21.d_na.M_runsapprox.C_bzip
spneumo_pangenome_k32	0.0001	prophasm	21	na	runsapprox	xz	791	16611	791	15820	791	791	16611	5468	4880	132	5012	5552	spneumo_pangenome_k32.r_0.0001.S_prophasm.k_21.d_na.M_runsapprox.C_xz
spneumo_pangenome_k32	0.001	prophasm	21	na	default	bzip	7910	165970	7910	158060	7903	7903	165970	50412	45388	62	45450	51204	spneumo_pangenome_k32.r_0.001.S_prophasm.k_21.d_na.M_default.C_bzip
spneumo_pangenome_k32	0.001	prophasm	21	na	default	xz	7910	165970	7910	158060	7903	7903	165970	50412	45388	200	45588	51204	spneumo_pangenome_k32.r_0.001.S_prophasm.k_21.d_na.M_default.C_xz
spneumo_pangenome_k32	0.001	prophasm	21	na	ones	bzip	7910	165970	7911	158059	7904	7903	165970	50412	45388	68	45456	51216	spneumo_pangenome_k32.r_0.001.S_prophasm.k_21.d_na.M_ones.C_bzip
spneumo_pangenome_k32	0.001	prophasm	21	na	ones	xz	7910	165970	7911	158059	7904	7903	165970	50412	45388	208	45596	51216	spneumo_pangenome_k32.r_0.001.S_prophasm.k_21.d_na.M_ones.C_xz
spneumo_pangenome_k32	0.001	prophasm	21	na	runsapprox	bzip	7910	165970	7911	158059	7904	7903	165970	50412	45388	68	45456	51216	spneumo_pangenome_k32.r_0.001.S_prophasm.k_21.d_na.M_runsapprox.C_bzip
spneumo_pangenome_k32	0.001	prophasm	21	na	runsapprox	xz	7910	165970	7911	158059	7904	7903	165970	50412	45388	208	45596	51216	spneumo_pangenome_k32.r_0.001.S_prophasm.k_21.d_na.M_runsapprox.C_xz
spneumo_pangenome_k32	0.01	prophasm	21	na	default	bzip	79100	1643740	79100	1564640	78232	78232	1643740	481572	430468	1515	431983	487852	spneumo_pangenome_k32.r_0.01.S_prophasm.k_21.d_na.M_default.C_bzip
spneumo_pangenome_k32	0.01	prophasm	21	na	default	xz	79100	1643740	79100	1564640	78232	78232	1643740	481572	430468	2636	433104	487852	spneumo_pangenome_k32.r_0.01.S_prophasm.k_21.d_na.M_default.C_xz
spneumo_pangenome_k32	0.01	prophasm	21	na	ones	bzip	79100	1643740	79275	1564465	78407	78232	1643740	481572	430468	1884	432352	488064	spneumo_pangenome_k32.r_0.01.S_prophasm.k_21.d_na.M_ones.C_bzip
spneumo_pangenome_k32	0.01	prophasm	21	na	ones	xz	79100	1643740	79275	1564465	78407	78232	1643740	481572	430468	3452	433920	488064	spneumo_pangenome_k32.r_0.01.S_prophasm.k_21.d_na.M_ones.C_xz
spneumo_pangenome_k32	0.01	prophasm	21	na	runsapprox	bzip	79100	1643740	79275	1564465	78407	78232	1643740	481572	430468	1884	432352	488064	spneumo_pangenome_k32.r_0.01.S_prophasm.k_21.d_na.M_runsapprox.C_bzip
spneumo_pangenome_k32	0.01	prophasm	21	na	runsapprox	xz	79100	1643740	79275	1564465	78407	78232	1643740	481572	430468	3452	433920	488064	spneumo_pangenome_k32.r_0.01.S_prophasm.k_21.d_na.M_runsapprox.C_xz
spneumo_pangenome_k32	0.05	prophasm	21	na	default	bzip	395503	7897143	395503	7501640	375082	375082	7897143	2259488	2018428	22573	2041001	2298588	spneumo_pangenome_k32.r_0.05.S_prophasm.k_21.d_na.M_default.C_bzip
spneumo_pangenome_k32	0.05	prophasm	21	na	default	xz	395503	7897143	395503	7501640	375082	375082	7897143	2259488	2018428	35744	2054172	2298588	spneumo_pangenome_k32.r_0.05.S_prophasm.k_21.d_na.M_default.C_xz
spneumo_pangenome_k32	0.05	prophasm	21	na	ones	bzip	395503	7897143	399551	7497592	379055	375082	7897143	2259488	2018428	29359	2047787	2301764	spneumo_pangenome_k32.r_0.05.S_prophasm.k_21.d_na.M_ones.C_bzip
spneumo_pangenome_k32	0.05	prophasm	21	na	ones	xz	395503	7897143	399551	7497592	379055	375082	7897143	2259488	2018428	50644	2069072	2301764	spneumo_pangenome_k32.r_0.05.S_prophasm.k_21.d_na.M_ones.C_xz
spneumo_pangenome_k32	0.05	prophasm	21	na	runsapprox	bzip	395503	7897143	399551	7497592	379055	375082	7897143	2259488	2018428	29359	2047787	2301764	spneumo_pangenome_k32.r_0.05.S_prophasm.k_21.d_na.M_runsapprox.C_bzip
spneumo_pangenome_k32	0.05	prophasm	21	na	runsapprox	xz	395503	7897143	399551	7497592	379055	375082	7897143	2259488	2018428	50644	2069072	2301764	spneumo_pangenome_k32.r_0.05.S_prophasm.k_21.d_na.M_runsapprox.C_xz
spneumo_pangenome_k32	0.1	prophasm	21	na	default	bzip	791006	14992306	791006	14201300	710065	710065	14992306	4227392	3778612	67583	3846195	4304528	spneumo_pangenome_k32.r_0.1.S_prophasm.k_21.d_na.M_default.C_bzip
spneumo_pangenome_k32	0.1	prophasm	21	na	default	xz	791006	14992306	791006	14201300	710065	710065	14992306	4227392	3778612	109732	3888344	4304528	spneumo_pangenome_k32.r_0.1.S_prophasm.k_21.d_na.M_default.C_xz
spneumo_pangenome_k32	0.1	prophasm	21	na	ones	bzip	791006	14992306	806368	14185938	724864	710065	14992306	4227392	3778612	90013	3868625	4320128	spneumo_pangenome_k32.r_0.1.S_prophasm.k_21.d_na.M_ones.C_bzip
spneumo_pangenome_k32	0.1	prophasm	21	na	ones	xz	791006	14992306	806368	14185938	724864	710065	14992306	4227392	3778612	155992	3934604	4320128	spneumo_pangenome_k32.r_0.1.S_prophasm.k_21.d_na.M_ones.C_xz
spneumo_pangenome_k32	0.1	prophasm	21	na	runsapprox	bzip	791006	14992306	806368	14185938	724864	710065	14992306	4227392	3778612	90013	3868625	4320128	spneumo_pangenome_k32.r_0.1.S_prophasm.k_21.d_na.M_runsapprox.C_bzip
spneumo_pangenome_k32	0.1	prophasm	21	na	runsapprox	xz	791006	14992306	806368	14185938	724864	710065	14992306	4227392	3778612	155992	3934604	4320128	spneumo_pangenome_k32.r_0.1.S_prophasm.k_21.d_na.M_runsapprox.C_xz
spneumo_pangenome_k32	0.2	prophasm	21	na	default	bzip	1582012	26799052	1582012	25217040	1260852	1260852	26799052	7410844	6615488	188931	6804419	7615344	spneumo_pangenome_k32.r_0.2.S_prophasm.k_21.d_na.M_default.C_bzip
spneumo_pangenome_k32	0.2	prophasm	21	na	default	xz	1582012	26799052	1582012	25217040	1260852	1260852	26799052	7410844	6615488	316988	6932476	7615344	spneumo_pangenome_k32.r_0.2.S_prophasm.k_21.d_na.M_default.C_xz
spneumo_pangenome_k32	0.2	prophasm	21	na	ones	bzip	1582012	26799052	1637152	25161900	1312129	1260852	26799052	7410844	6615488	259461	6874949	7674244	spneumo_pangenome_k32.r_0.2.S_prophasm.k_21.d_na.M_ones.C_bzip
spneumo_pangenome_k32	0.2	prophasm	21	na	ones	xz	1582012	26799052	1637152	25161900	1312129	1260852	26799052	7410844	6615488	443804	7059292	7674244	spneumo_pangenome_k32.r_0.2.S_prophasm.k_21.d_na.M_ones.C_xz
spneumo_pangenome_k32	0.2	prophasm	21	na	runsapprox	bzip	1582012	26799052	1637152	25161900	1312129	1260852	26799052	7410844	6615488	259461	6874949	7674244	spneumo_pangenome_k32.r_0.2.S_prophasm.k_21.d_na.M_runsapprox.C_bzip
spneumo_pangenome_k32	0.2	prophasm	21	na	runsapprox	xz	1582012	26799052	1637152	25161900	1312129	1260852	26799052	7410844	6615488	443804	7059292	7674244	spneumo_pangenome_k32.r_0.2.S_prophasm.k_21.d_na.M_runsapprox.C_xz
spneumo_pangenome_k32	0.3	prophasm	21	na	default	bzip	2373018	35438678	2373018	33065660	1653283	1653283	35438678	9632440	8605800	331209	8937009	10038712	spneumo_pangenome_k32.r_0.3.S_prophasm.k_21.d_na.M_default.C_bzip
spneumo_pangenome_k32	0.3	prophasm	21	na	default	xz	2373018	35438678	2373018	33065660	1653283	1653283	35438678	9632440	8605800	553836	9159636	10038712	spneumo_pangenome_k32.r_0.3.S_prophasm.k_21.d_na.M_default.C_xz
spneumo_pangenome_k32	0.3	prophasm	21	na	ones	bzip	2373018	35438678	2481687	32956991	1750122	1653283	35438678	9632440	8605800	460888	9066688	10143172	spneumo_pangenome_k32.r_0.3.S_prophasm.k_21.d_na.M_ones.C_bzip
spneumo_pangenome_k32	0.3	prophasm	21	na	ones	xz	2373018	35438678	2481687	32956991	1750122	1653283	35438678	9632440	8605800	756424	9362224	10143172	spneumo_pangenome_k32.r_0.3.S_prophasm.k_21.d_na.M_ones.C_xz
spneumo_pangenome_k32	0.3	prophasm	21	na	runsapprox	bzip	2373018	35438678	2481687	32956991	1750122	1653283	35438678	9632440	8605800	460888	9066688	10143172	spneumo_pangenome_k32.r_0.3.S_prophasm.k_21.d_na.M_runsapprox.C_bzip
spneumo_pangenome_k32	0.3	prophasm	21	na	runsapprox	xz	2373018	35438678	2481687	32956991	1750122	1653283	35438678	9632440	8605800	756424	9362224	10143172	spneumo_pangenome_k32.r_0.3.S_prophasm.k_21.d_na.M_runsapprox.C_xz
spneumo_pangenome_k32	0.4	prophasm	21	na	default	bzip	3164024	40984704	3164024	37820680	1891034	1891034	40984704	10991536	9842108	474434	10316542	11617692	spneumo_pangenome_k32.r_0.4.S_prophasm.k_21.d_na.M_default.C_bzip
spneumo_pangenome_k32	0.4	prophasm	21	na	default	xz	3164024	40984704	3164024	37820680	1891034	1891034	40984704	10991536	9842108	776552	10618660	11617692	spneumo_pangenome_k32.r_0.4.S_prophasm.k_21.d_na.M_default.C_xz
spneumo_pangenome_k32	0.4	prophasm	21	na	ones	bzip	3164024	40984704	3331990	37652714	2033888	1891034	40984704	10991536	9842108	664958	10507066	11769408	spneumo_pangenome_k32.r_0.4.S_prophasm.k_21.d_na.M_ones.C_bzip
spneumo_pangenome_k32	0.4	prophasm	21	na	ones	xz	3164024	40984704	3331990	37652714	2033888	1891034	40984704	10991536	9842108	1037684	10879792	11769408	spneumo_pangenome_k32.r_0.4.S_prophasm.k_21.d_na.M_ones.C_xz
spneumo_pangenome_k32	0.4	prophasm	21	na	runsapprox	bzip	3164024	40984704	3331990	37652714	2033888	1891034	40984704	10991536	9842108	664958	10507066	11769408	spneumo_pangenome_k32.r_0.4.S_prophasm.k_21.d_na.M_runsapprox.C_bzip
spneumo_pangenome_k32	0.4	prophasm	21	na	runsapprox	xz	3164024	40984704	3331990	37652714	2033888	1891034	40984704	10991536	9842108	1037684	10879792	11769408	spneumo_pangenome_k32.r_0.4.S_prophasm.k_21.d_na.M_runsapprox.C_xz
spneumo_pangenome_k32	0.5	prophasm	21	na	default	bzip	3955030	43468650	3955030	39513620	1975681	1975681	43468650	11535704	10339880	599093	10938973	12381620	spneumo_pangenome_k32.r_0.5.S_prophasm.k_21.d_na.M_default.C_bzip
spneumo_pangenome_k32	0.5	prophasm	21	na	default	xz	3955030	43468650	3955030	39513620	1975681	1975681	43468650	11535704	10339880	952424	11292304	12381620	spneumo_pangenome_k32.r_0.5.S_prophasm.k_21.d_na.M_default.C_xz
spneumo_pangenome_k32	0.5	prophasm	21	na	ones	bzip	3955030	43468650	4176402	39292248	2154191	1975681	43468650	11535704	10339880	839659	11179539	12575520	spneumo_pangenome_k32.r_0.5.S_prophasm.k_21.d_na.M_ones.C_bzip
spneumo_pangenome_k32	0.5	prophasm	21	na	ones	xz	3955030	43468650	4176402	39292248	2154191	1975681	43468650	11535704	10339880	1250040	11589920	12575520	spneumo_pangenome_k32.r_0.5.S_prophasm.k_21.d_na.M_ones.C_xz
spneumo_pangenome_k32	0.5	prophasm	21	na	runsapprox	bzip	3955030	43468650	4176402	39292248	2154191	1975681	43468650	11535704	10339880	839659	11179539	12575520	spneumo_pangenome_k32.r_0.5.S_prophasm.k_21.d_na.M_runsapprox.C_bzip
spneumo_pangenome_k32	0.5	prophasm	21	na	runsapprox	xz	3955030	43468650	4176402	39292248	2154191	1975681	43468650	11535704	10339880	1250040	11589920	12575520	spneumo_pangenome_k32.r_0.5.S_prophasm.k_21.d_na.M_runsapprox.C_xz
spneumo_pangenome_k32	0.6	prophasm	21	na	default	bzip	4746036	42918056	4746036	38172020	1908601	1908601	42918056	11299680	10144492	682510	10827002	12340912	spneumo_pangenome_k32.r_0.6.S_prophasm.k_21.d_na.M_default.C_bzip
spneumo_pangenome_k32	0.6	prophasm	21	na	default	xz	4746036	42918056	4746036	38172020	1908601	1908601	42918056	11299680	10144492	1053672	11198164	12340912	spneumo_pangenome_k32.r_0.6.S_prophasm.k_21.d_na.M_default.C_xz
spneumo_pangenome_k32	0.6	prophasm	21	na	ones	bzip	4746036	42918056	5007364	37910692	2105456	1908601	42918056	11299680	10144492	956359	11100851	12546196	spneumo_pangenome_k32.r_0.6.S_prophasm.k_21.d_na.M_ones.C_bzip
spneumo_pangenome_k32	0.6	prophasm	21	na	ones	xz	4746036	42918056	5007364	37910692	2105456	1908601	42918056	11299680	10144492	1363536	11508028	12546196	spneumo_pangenome_k32.r_0.6.S_prophasm.k_21.d_na.M_ones.C_xz
spneumo_pangenome_k32	0.6	prophasm	21	na	runsapprox	bzip	4746036	42918056	5007364	37910692	2105456	1908601	42918056	11299680	10144492	956359	11100851	12546196	spneumo_pangenome_k32.r_0.6.S_prophasm.k_21.d_na.M_runsapprox.C_bzip
spneumo_pangenome_k32	0.6	prophasm	21	na	runsapprox	xz	4746036	42918056	5007364	37910692	2105456	1908601	42918056	11299680	10144492	1363536	11508028	12546196	spneumo_pangenome_k32.r_0.6.S_prophasm.k_21.d_na.M_runsapprox.C_xz
spneumo_pangenome_k32	0.7	prophasm	21	na	default	bzip	5537042	39373582	5537042	33836540	1691827	1691827	39373582	10304276	9266384	702277	9968661	11499808	spneumo_pangenome_k32.r_0.7.S_prophasm.k_21.d_na.M_default.C_bzip
spneumo_pangenome_k32	0.7	prophasm	21	na	default	xz	5537042	39373582	5537042	33836540	1691827	1691827	39373582	10304276	9266384	1057976	10324360	11499808	spneumo_pangenome_k32.r_0.7.S_prophasm.k_21.d_na.M_default.C_xz
spneumo_pangenome_k32	0.7	prophasm	21	na	ones	bzip	5537042	39373582	5817422	33556160	1885080	1691827	39373582	10304276	9266384	983499	10249883	11685136	spneumo_pangenome_k32.r_0.7.S_prophasm.k_21.d_na.M_ones.C_bzip
spneumo_pangenome_k32	0.7	prophasm	21	na	ones	xz	5537042	39373582	5817422	33556160	1885080	1691827	39373582	10304276	9266384	1355812	10622196	11685136	spneumo_pangenome_k32.r_0.7.S_prophasm.k_21.d_na.M_ones.C_xz
spneumo_pangenome_k32	0.7	prophasm	21	na	runsapprox	bzip	5537042	39373582	5817422	33556160	1885080	1691827	39373582	10304276	9266384	983499	10249883	11685136	spneumo_pangenome_k32.r_0.7.S_prophasm.k_21.d_na.M_runsapprox.C_bzip
spneumo_pangenome_k32	0.7	prophasm	21	na	runsapprox	xz	5537042	39373582	5817422	33556160	1885080	1691827	39373582	10304276	9266384	1355812	10622196	11685136	spneumo_pangenome_k32.r_0.7.S_prophasm.k_21.d_na.M_runsapprox.C_xz
spneumo_pangenome_k32	0.8	prophasm	21	na	default	bzip	6328048	32863648	6328048	26535600	1326780	1326780	32863648	8553880	7714640	638441	8353081	9797572	spneumo_pangenome_k32.r_0.8.S_prophasm.k_21.d_na.M_default.C_bzip
spneumo_pangenome_k32	0.8	prophasm	21	na	default	xz	6328048	32863648	6328048	26535600	1326780	1326780	32863648	8553880	7714640	947248	8661888	9797572	spneumo_pangenome_k32.r_0.8.S_prophasm.k_21.d_na.M_default.C_xz
spneumo_pangenome_k32	0.8	prophasm	21	na	ones	bzip	6328048	32863648	6596676	26266972	1488547	1326780	32863648	8553880	7714640	893153	8607793	9971348	spneumo_pangenome_k32.r_0.8.S_prophasm.k_21.d_na.M_ones.C_bzip
spneumo_pangenome_k32	0.8	prophasm	21	na	ones	xz	6328048	32863648	6596676	26266972	1488547	1326780	32863648	8553880	7714640	1205824	8920464	9971348	spneumo_pangenome_k32.r_0.8.S_prophasm.k_21.d_na.M_ones.C_xz
spneumo_pangenome_k32	0.8	prophasm	21	na	runsapprox	bzip	6328048	32863648	6596676	26266972	1488547	1326780	32863648	8553880	7714640	893153	8607793	9971348	spneumo_pangenome_k32.r_0.8.S_prophasm.k_21.d_na.M_runsapprox.C_bzip
spneumo_pangenome_k32	0.8	prophasm	21	na	runsapprox	xz	6328048	32863648	6596676	26266972	1488547	1326780	32863648	8553880	7714640	1205824	8920464	9971348	spneumo_pangenome_k32.r_0.8.S_prophasm.k_21.d_na.M_runsapprox.C_xz
spneumo_pangenome_k32	0.9	prophasm	21	na	default	bzip	7119054	23421434	7119054	16302380	815119	815119	23421434	6006348	5455728	469237	5924965	7011188	spneumo_pangenome_k32.r_0.9.S_prophasm.k_21.d_na.M_default.C_bzip
spneumo_pangenome_k32	0.9	prophasm	21	na	default	xz	7119054	23421434	7119054	16302380	815119	815119	23421434	6006348	5455728	707088	6162816	7011188	spneumo_pangenome_k32.r_0.9.S_prophasm.k_21.d_na.M_default.C_xz
spneumo_pangenome_k32	0.9	prophasm	21	na	ones	bzip	7119054	23421434	7334744	16086690	912483	815119	23421434	6006348	5455728	654741	6110469	7135720	spneumo_pangenome_k32.r_0.9.S_prophasm.k_21.d_na.M_ones.C_bzip
spneumo_pangenome_k32	0.9	prophasm	21	na	ones	xz	7119054	23421434	7334744	16086690	912483	815119	23421434	6006348	5455728	886172	6341900	7135720	spneumo_pangenome_k32.r_0.9.S_prophasm.k_21.d_na.M_ones.C_xz
spneumo_pangenome_k32	0.9	prophasm	21	na	runsapprox	bzip	7119054	23421434	7334744	16086690	912483	815119	23421434	6006348	5455728	654741	6110469	7135720	spneumo_pangenome_k32.r_0.9.S_prophasm.k_21.d_na.M_runsapprox.C_bzip
spneumo_pangenome_k32	0.9	prophasm	21	na	runsapprox	xz	7119054	23421434	7334744	16086690	912483	815119	23421434	6006348	5455728	886172	6341900	7135720	spneumo_pangenome_k32.r_0.9.S_prophasm.k_21.d_na.M_runsapprox.C_xz
spneumo_pangenome_k32	1.0	prophasm	21	na	default	bzip	7910060	11084100	7910060	3174040	158702	158702	11084100	2433948	2337616	115951	2453567	2901380	spneumo_pangenome_k32.r_1.0.S_prophasm.k_21.d_na.M_default.C_bzip
spneumo_pangenome_k32	1.0	prophasm	21	na	default	xz	7910060	11084100	7910060	3174040	158702	158702	11084100	2433948	2337616	189756	2527372	2901380	spneumo_pangenome_k32.r_1.0.S_prophasm.k_21.d_na.M_default.C_xz
spneumo_pangenome_k32	1.0	prophasm	21	na	ones	bzip	7910060	11084100	8030455	3053645	158945	158702	11084100	2433948	2337616	164023	2501639	2911952	spneumo_pangenome_k32.r_1.0.S_prophasm.k_21.d_na.M_ones.C_bzip
spneumo_pangenome_k32	1.0	prophasm	21	na	ones	xz	7910060	11084100	8030455	3053645	158945	158702	11084100	2433948	2337616	239544	2577160	2911952	spneumo_pangenome_k32.r_1.0.S_prophasm.k_21.d_na.M_ones.C_xz
spneumo_pangenome_k32	1.0	prophasm	21	na	runsapprox	bzip	7910060	11084100	8030455	3053645	158945	158702	11084100	2433948	2337616	164023	2501639	2911952	spneumo_pangenome_k32.r_1.0.S_prophasm.k_21.d_na.M_runsapprox.C_bzip
spneumo_pangenome_k32	1.0	prophasm	21	na	runsapprox	xz	7910060	11084100	8030455	3053645	158945	158702	11084100	2433948	2337616	239544	2577160	2911952	spneumo_pangenome_k32.r_1.0.S_prophasm.k_21.d_na.M_runsapprox.C_xz
spneumo_pangenome_k32	0.000000001	eulertigs	23	na	default	bzip	1	23	1	22	1	1	23	92	88	41	129	88	spneumo_pangenome_k32.r_0.000000001.S_eulertigs.k_23.d_na.M_default.C_bzip
spneumo_pangenome_k32	0.000000001	eulertigs	23	na	default	xz	1	23	1	22	1	1	23	92	88	76	164	88	spneumo_pangenome_k32.r_0.000000001.S_eulertigs.k_23.d_na.M_default.C_xz
spneumo_pangenome_k32	0.000000001	eulertigs	23	na	ones	bzip	1	23	1	22	1	1	23	92	88	41	129	88	spneumo_pangenome_k32.r_0.000000001.S_eulertigs.k_23.d_na.M_ones.C_bzip
spneumo_pangenome_k32	0.000000001	eulertigs	23	na	ones	xz	1	23	1	22	1	1	23	92	88	76	164	88	spneumo_pangenome_k32.r_0.000000001.S_eulertigs.k_23.d_na.M_ones.C_xz
spneumo_pangenome_k32	0.000000001	eulertigs	23	na	runsapprox	bzip	1	23	1	22	1	1	23	92	88	41	129	88	spneumo_pangenome_k32.r_0.000000001.S_eulertigs.k_23.d_na.M_runsapprox.C_bzip
spneumo_pangenome_k32	0.000000001	eulertigs	23	na	runsapprox	xz	1	23	1	22	1	1	23	92	88	76	164	88	spneumo_pangenome_k32.r_0.000000001.S_eulertigs.k_23.d_na.M_runsapprox.C_xz
spneumo_pangenome_k32	0.0001	eulertigs	23	na	default	bzip	826	18998	826	18172	826	826	18998	5672	5388	47	5435	5704	spneumo_pangenome_k32.r_0.0001.S_eulertigs.k_23.d_na.M_default.C_bzip
spneumo_pangenome_k32	0.0001	eulertigs	23	na	default	xz	826	18998	826	18172	826	826	18998	5672	5388	136	5524	5704	spneumo_pangenome_k32.r_0.0001.S_eulertigs.k_23.d_na.M_default.C_xz
spneumo_pangenome_k32	0.0001	eulertigs	23	na	ones	bzip	826	18998	826	18172	826	826	18998	5672	5388	47	5435	5704	spneumo_pangenome_k32.r_0.0001.S_eulertigs.k_23.d_na.M_ones.C_bzip
spneumo_pangenome_k32	0.0001	eulertigs	23	na	ones	xz	826	18998	826	18172	826	826	18998	5672	5388	136	5524	5704	spneumo_pangenome_k32.r_0.0001.S_eulertigs.k_23.d_na.M_ones.C_xz
spneumo_pangenome_k32	0.0001	eulertigs	23	na	runsapprox	bzip	826	18998	826	18172	826	826	18998	5672	5388	47	5435	5704	spneumo_pangenome_k32.r_0.0001.S_eulertigs.k_23.d_na.M_runsapprox.C_bzip
spneumo_pangenome_k32	0.0001	eulertigs	23	na	runsapprox	xz	826	18998	826	18172	826	826	18998	5672	5388	136	5524	5704	spneumo_pangenome_k32.r_0.0001.S_eulertigs.k_23.d_na.M_runsapprox.C_xz
spneumo_pangenome_k32	0.001	eulertigs	23	na	default	bzip	8260	189672	8260	181412	8246	8246	189672	53972	51240	77	51317	55216	spneumo_pangenome_k32.r_0.001.S_eulertigs.k_23.d_na.M_default.C_bzip
spneumo_pangenome_k32	0.001	eulertigs	23	na	default	xz	8260	189672	8260	181412	8246	8246	189672	53972	51240	232	51472	55216	spneumo_pangenome_k32.r_0.001.S_eulertigs.k_23.d_na.M_default.C_xz
spneumo_pangenome_k32	0.001	eulertigs	23	na	ones	bzip	8260	189672	8262	181410	8248	8246	189672	53972	51240	87	51327	55240	spneumo_pangenome_k32.r_0.001.S_eulertigs.k_23.d_na.M_ones.C_bzip
spneumo_pangenome_k32	0.001	eulertigs	23	na	ones	xz	8260	189672	8262	181410	8248	8246	189672	53972	51240	244	51484	55240	spneumo_pangenome_k32.r_0.001.S_eulertigs.k_23.d_na.M_ones.C_xz
spneumo_pangenome_k32	0.001	eulertigs	23	na	runsapprox	bzip	8260	189672	8262	181410	8248	8246	189672	53972	51240	87	51327	55240	spneumo_pangenome_k32.r_0.001.S_eulertigs.k_23.d_na.M_runsapprox.C_bzip
spneumo_pangenome_k32	0.001	eulertigs	23	na	runsapprox	xz	8260	189672	8262	181410	8248	8246	189672	53972	51240	244	51484	55240	spneumo_pangenome_k32.r_0.001.S_eulertigs.k_23.d_na.M_runsapprox.C_xz
spneumo_pangenome_k32	0.01	eulertigs	23	na	default	bzip	82605	1882183	82605	1799578	81799	81799	1882183	537800	487176	1456	488632	548312	spneumo_pangenome_k32.r_0.01.S_eulertigs.k_23.d_na.M_default.C_bzip
spneumo_pangenome_k32	0.01	eulertigs	23	na	default	xz	82605	1882183	82605	1799578	81799	81799	1882183	537800	487176	2700	489876	548312	spneumo_pangenome_k32.r_0.01.S_eulertigs.k_23.d_na.M_default.C_xz
spneumo_pangenome_k32	0.01	eulertigs	23	na	ones	bzip	82605	1882183	82748	1799435	81942	81799	1882183	537800	487176	1754	488930	548396	spneumo_pangenome_k32.r_0.01.S_eulertigs.k_23.d_na.M_ones.C_bzip
spneumo_pangenome_k32	0.01	eulertigs	23	na	ones	xz	82605	1882183	82748	1799435	81942	81799	1882183	537800	487176	3420	490596	548396	spneumo_pangenome_k32.r_0.01.S_eulertigs.k_23.d_na.M_ones.C_xz
spneumo_pangenome_k32	0.01	eulertigs	23	na	runsapprox	bzip	82605	1882183	82748	1799435	81942	81799	1882183	537800	487176	1754	488930	548396	spneumo_pangenome_k32.r_0.01.S_eulertigs.k_23.d_na.M_runsapprox.C_bzip
spneumo_pangenome_k32	0.01	eulertigs	23	na	runsapprox	xz	82605	1882183	82748	1799435	81942	81799	1882183	537800	487176	3420	490596	548396	spneumo_pangenome_k32.r_0.01.S_eulertigs.k_23.d_na.M_runsapprox.C_xz
spneumo_pangenome_k32	0.05	eulertigs	23	na	default	bzip	413029	9037293	413029	8624264	392012	392012	9037293	2504396	2242736	24854	2267590	2559492	spneumo_pangenome_k32.r_0.05.S_eulertigs.k_23.d_na.M_default.C_bzip
spneumo_pangenome_k32	0.05	eulertigs	23	na	default	xz	413029	9037293	413029	8624264	392012	392012	9037293	2504396	2242736	43452	2286188	2559492	spneumo_pangenome_k32.r_0.05.S_eulertigs.k_23.d_na.M_default.C_xz
spneumo_pangenome_k32	0.05	eulertigs	23	na	ones	bzip	413029	9037293	416995	8620298	395902	392012	9037293	2504396	2242736	31289	2274025	2561912	spneumo_pangenome_k32.r_0.05.S_eulertigs.k_23.d_na.M_ones.C_bzip
spneumo_pangenome_k32	0.05	eulertigs	23	na	ones	xz	413029	9037293	416995	8620298	395902	392012	9037293	2504396	2242736	57352	2300088	2561912	spneumo_pangenome_k32.r_0.05.S_eulertigs.k_23.d_na.M_ones.C_xz
spneumo_pangenome_k32	0.05	eulertigs	23	na	runsapprox	bzip	413029	9037293	416995	8620298	395902	392012	9037293	2504396	2242736	31289	2274025	2561912	spneumo_pangenome_k32.r_0.05.S_eulertigs.k_23.d_na.M_runsapprox.C_bzip
spneumo_pangenome_k32	0.05	eulertigs	23	na	runsapprox	xz	413029	9037293	416995	8620298	395902	392012	9037293	2504396	2242736	57352	2300088	2561912	spneumo_pangenome_k32.r_0.05.S_eulertigs.k_23.d_na.M_runsapprox.C_xz
spneumo_pangenome_k32	0.1	eulertigs	23	na	default	bzip	826059	17156483	826059	16330424	742292	742292	17156483	4638624	4148060	75226	4223286	4762560	spneumo_pangenome_k32.r_0.1.S_eulertigs.k_23.d_na.M_default.C_bzip
spneumo_pangenome_k32	0.1	eulertigs	23	na	default	xz	826059	17156483	826059	16330424	742292	742292	17156483	4638624	4148060	130436	4278496	4762560	spneumo_pangenome_k32.r_0.1.S_eulertigs.k_23.d_na.M_default.C_xz
spneumo_pangenome_k32	0.1	eulertigs	23	na	ones	bzip	826059	17156483	841472	16315011	757228	742292	17156483	4638624	4148060	97564	4245624	4772760	spneumo_pangenome_k32.r_0.1.S_eulertigs.k_23.d_na.M_ones.C_bzip
spneumo_pangenome_k32	0.1	eulertigs	23	na	ones	xz	826059	17156483	841472	16315011	757228	742292	17156483	4638624	4148060	175516	4323576	4772760	spneumo_pangenome_k32.r_0.1.S_eulertigs.k_23.d_na.M_ones.C_xz
spneumo_pangenome_k32	0.1	eulertigs	23	na	runsapprox	bzip	826059	17156483	841472	16315011	757228	742292	17156483	4638624	4148060	97564	4245624	4772760	spneumo_pangenome_k32.r_0.1.S_eulertigs.k_23.d_na.M_runsapprox.C_bzip
spneumo_pangenome_k32	0.1	eulertigs	23	na	runsapprox	xz	826059	17156483	841472	16315011	757228	742292	17156483	4638624	4148060	175516	4323576	4772760	spneumo_pangenome_k32.r_0.1.S_eulertigs.k_23.d_na.M_runsapprox.C_xz
spneumo_pangenome_k32	0.2	eulertigs	23	na	default	bzip	1652118	30629000	1652118	28976882	1317131	1317131	30629000	8046104	7204068	211525	7415593	8367772	spneumo_pangenome_k32.r_0.2.S_eulertigs.k_23.d_na.M_default.C_bzip
spneumo_pangenome_k32	0.2	eulertigs	23	na	default	xz	1652118	30629000	1652118	28976882	1317131	1317131	30629000	8046104	7204068	363264	7567332	8367772	spneumo_pangenome_k32.r_0.2.S_eulertigs.k_23.d_na.M_default.C_xz
spneumo_pangenome_k32	0.2	eulertigs	23	na	ones	bzip	1652118	30629000	1707249	28921751	1368398	1317131	30629000	8046104	7204068	281261	7485329	8406668	spneumo_pangenome_k32.r_0.2.S_eulertigs.k_23.d_na.M_ones.C_bzip
spneumo_pangenome_k32	0.2	eulertigs	23	na	ones	xz	1652118	30629000	1707249	28921751	1368398	1317131	30629000	8046104	7204068	493432	7697500	8406668	spneumo_pangenome_k32.r_0.2.S_eulertigs.k_23.d_na.M_ones.C_xz
spneumo_pangenome_k32	0.2	eulertigs	23	na	runsapprox	bzip	1652118	30629000	1707249	28921751	1368398	1317131	30629000	8046104	7204068	281261	7485329	8406668	spneumo_pangenome_k32.r_0.2.S_eulertigs.k_23.d_na.M_runsapprox.C_bzip
spneumo_pangenome_k32	0.2	eulertigs	23	na	runsapprox	xz	1652118	30629000	1707249	28921751	1368398	1317131	30629000	8046104	7204068	493432	7697500	8406668	spneumo_pangenome_k32.r_0.2.S_eulertigs.k_23.d_na.M_runsapprox.C_xz
spneumo_pangenome_k32	0.3	eulertigs	23	na	default	bzip	2478177	40478051	2478177	37999874	1727267	1727267	40478051	10438700	9359544	371787	9731331	10992284	spneumo_pangenome_k32.r_0.3.S_eulertigs.k_23.d_na.M_default.C_bzip
spneumo_pangenome_k32	0.3	eulertigs	23	na	default	xz	2478177	40478051	2478177	37999874	1727267	1727267	40478051	10438700	9359544	634140	9993684	10992284	spneumo_pangenome_k32.r_0.3.S_eulertigs.k_23.d_na.M_default.C_xz
spneumo_pangenome_k32	0.3	eulertigs	23	na	ones	bzip	2478177	40478051	2587186	37890865	1824528	1727267	40478051	10438700	9359544	500156	9859700	11072112	spneumo_pangenome_k32.r_0.3.S_eulertigs.k_23.d_na.M_ones.C_bzip
spneumo_pangenome_k32	0.3	eulertigs	23	na	ones	xz	2478177	40478051	2587186	37890865	1824528	1727267	40478051	10438700	9359544	843740	10203284	11072112	spneumo_pangenome_k32.r_0.3.S_eulertigs.k_23.d_na.M_ones.C_xz
spneumo_pangenome_k32	0.3	eulertigs	23	na	runsapprox	bzip	2478177	40478051	2587186	37890865	1824528	1727267	40478051	10438700	9359544	500156	9859700	11072112	spneumo_pangenome_k32.r_0.3.S_eulertigs.k_23.d_na.M_runsapprox.C_bzip
spneumo_pangenome_k32	0.3	eulertigs	23	na	runsapprox	xz	2478177	40478051	2587186	37890865	1824528	1727267	40478051	10438700	9359544	843740	10203284	11072112	spneumo_pangenome_k32.r_0.3.S_eulertigs.k_23.d_na.M_runsapprox.C_xz
spneumo_pangenome_k32	0.4	eulertigs	23	na	default	bzip	3304237	46778723	3304237	43474486	1976113	1976113	46778723	11877000	10657200	534186	11191386	12682288	spneumo_pangenome_k32.r_0.4.S_eulertigs.k_23.d_na.M_default.C_bzip
spneumo_pangenome_k32	0.4	eulertigs	23	na	default	xz	3304237	46778723	3304237	43474486	1976113	1976113	46778723	11877000	10657200	897408	11554608	12682288	spneumo_pangenome_k32.r_0.4.S_eulertigs.k_23.d_na.M_default.C_xz
spneumo_pangenome_k32	0.4	eulertigs	23	na	ones	bzip	3304237	46778723	3471495	43307228	2118861	1976113	46778723	11877000	10657200	722619	11379819	12810724	spneumo_pangenome_k32.r_0.4.S_eulertigs.k_23.d_na.M_ones.C_bzip
spneumo_pangenome_k32	0.4	eulertigs	23	na	ones	xz	3304237	46778723	3471495	43307228	2118861	1976113	46778723	11877000	10657200	1163508	11820708	12810724	spneumo_pangenome_k32.r_0.4.S_eulertigs.k_23.d_na.M_ones.C_xz
spneumo_pangenome_k32	0.4	eulertigs	23	na	runsapprox	bzip	3304237	46778723	3471495	43307228	2118861	1976113	46778723	11877000	10657200	722619	11379819	12810724	spneumo_pangenome_k32.r_0.4.S_eulertigs.k_23.d_na.M_runsapprox.C_bzip
spneumo_pangenome_k32	0.4	eulertigs	23	na	runsapprox	xz	3304237	46778723	3471495	43307228	2118861	1976113	46778723	11877000	10657200	1163508	11820708	12810724	spneumo_pangenome_k32.r_0.4.S_eulertigs.k_23.d_na.M_runsapprox.C_xz
spneumo_pangenome_k32	0.5	eulertigs	23	na	default	bzip	4130296	49543290	4130296	45412994	2064227	2064227	49543290	12491684	11226804	678740	11905544	13541464	spneumo_pangenome_k32.r_0.5.S_eulertigs.k_23.d_na.M_default.C_bzip
spneumo_pangenome_k32	0.5	eulertigs	23	na	default	xz	4130296	49543290	4130296	45412994	2064227	2064227	49543290	12491684	11226804	1110252	12337056	13541464	spneumo_pangenome_k32.r_0.5.S_eulertigs.k_23.d_na.M_default.C_xz
spneumo_pangenome_k32	0.5	eulertigs	23	na	ones	bzip	4130296	49543290	4352515	45190775	2243913	2064227	49543290	12491684	11226804	919043	12145847	13704252	spneumo_pangenome_k32.r_0.5.S_eulertigs.k_23.d_na.M_ones.C_bzip
spneumo_pangenome_k32	0.5	eulertigs	23	na	ones	xz	4130296	49543290	4352515	45190775	2243913	2064227	49543290	12491684	11226804	1407648	12634452	13704252	spneumo_pangenome_k32.r_0.5.S_eulertigs.k_23.d_na.M_ones.C_xz
spneumo_pangenome_k32	0.5	eulertigs	23	na	runsapprox	bzip	4130296	49543290	4352515	45190775	2243913	2064227	49543290	12491684	11226804	919043	12145847	13704252	spneumo_pangenome_k32.r_0.5.S_eulertigs.k_23.d_na.M_runsapprox.C_bzip
spneumo_pangenome_k32	0.5	eulertigs	23	na	runsapprox	xz	4130296	49543290	4352515	45190775	2243913	2064227	49543290	12491684	11226804	1407648	12634452	13704252	spneumo_pangenome_k32.r_0.5.S_eulertigs.k_23.d_na.M_runsapprox.C_xz
spneumo_pangenome_k32	0.6	eulertigs	23	na	default	bzip	4956355	48833441	4956355	43877086	1994413	1994413	48833441	12254032	11042448	782471	11824919	13504556	spneumo_pangenome_k32.r_0.6.S_eulertigs.k_23.d_na.M_default.C_bzip
spneumo_pangenome_k32	0.6	eulertigs	23	na	default	xz	4956355	48833441	4956355	43877086	1994413	1994413	48833441	12254032	11042448	1235032	12277480	13504556	spneumo_pangenome_k32.r_0.6.S_eulertigs.k_23.d_na.M_default.C_xz
spneumo_pangenome_k32	0.6	eulertigs	23	na	ones	bzip	4956355	48833441	5218820	43614621	2193207	1994413	48833441	12254032	11042448	1056925	12099373	13698836	spneumo_pangenome_k32.r_0.6.S_eulertigs.k_23.d_na.M_ones.C_bzip
spneumo_pangenome_k32	0.6	eulertigs	23	na	ones	xz	4956355	48833441	5218820	43614621	2193207	1994413	48833441	12254032	11042448	1537460	12579908	13698836	spneumo_pangenome_k32.r_0.6.S_eulertigs.k_23.d_na.M_ones.C_xz
spneumo_pangenome_k32	0.6	eulertigs	23	na	runsapprox	bzip	4956355	48833441	5218820	43614621	2193207	1994413	48833441	12254032	11042448	1056925	12099373	13698836	spneumo_pangenome_k32.r_0.6.S_eulertigs.k_23.d_na.M_runsapprox.C_bzip
spneumo_pangenome_k32	0.6	eulertigs	23	na	runsapprox	xz	4956355	48833441	5218820	43614621	2193207	1994413	48833441	12254032	11042448	1537460	12579908	13698836	spneumo_pangenome_k32.r_0.6.S_eulertigs.k_23.d_na.M_runsapprox.C_xz
spneumo_pangenome_k32	0.7	eulertigs	23	na	default	bzip	5782415	44651619	5782415	38869204	1766782	1766782	44651619	11183528	10087780	815309	10903089	12565428	spneumo_pangenome_k32.r_0.7.S_eulertigs.k_23.d_na.M_default.C_bzip
spneumo_pangenome_k32	0.7	eulertigs	23	na	default	xz	5782415	44651619	5782415	38869204	1766782	1766782	44651619	11183528	10087780	1240920	11328700	12565428	spneumo_pangenome_k32.r_0.7.S_eulertigs.k_23.d_na.M_default.C_xz
spneumo_pangenome_k32	0.7	eulertigs	23	na	ones	bzip	5782415	44651619	6063772	38587847	1962038	1766782	44651619	11183528	10087780	1096908	11184688	12772012	spneumo_pangenome_k32.r_0.7.S_eulertigs.k_23.d_na.M_ones.C_bzip
spneumo_pangenome_k32	0.7	eulertigs	23	na	ones	xz	5782415	44651619	6063772	38587847	1962038	1766782	44651619	11183528	10087780	1527464	11615244	12772012	spneumo_pangenome_k32.r_0.7.S_eulertigs.k_23.d_na.M_ones.C_xz
spneumo_pangenome_k32	0.7	eulertigs	23	na	runsapprox	bzip	5782415	44651619	6063772	38587847	1962038	1766782	44651619	11183528	10087780	1096908	11184688	12772012	spneumo_pangenome_k32.r_0.7.S_eulertigs.k_23.d_na.M_runsapprox.C_bzip
spneumo_pangenome_k32	0.7	eulertigs	23	na	runsapprox	xz	5782415	44651619	6063772	38587847	1962038	1766782	44651619	11183528	10087780	1527464	11615244	12772012	spneumo_pangenome_k32.r_0.7.S_eulertigs.k_23.d_na.M_runsapprox.C_xz
spneumo_pangenome_k32	0.8	eulertigs	23	na	default	bzip	6608474	37084898	6608474	30476424	1385292	1385292	37084898	9261792	8366764	749821	9116585	10670244	spneumo_pangenome_k32.r_0.8.S_eulertigs.k_23.d_na.M_default.C_bzip
spneumo_pangenome_k32	0.8	eulertigs	23	na	default	xz	6608474	37084898	6608474	30476424	1385292	1385292	37084898	9261792	8366764	1102296	9469060	10670244	spneumo_pangenome_k32.r_0.8.S_eulertigs.k_23.d_na.M_default.C_xz
spneumo_pangenome_k32	0.8	eulertigs	23	na	ones	bzip	6608474	37084898	6880077	30204821	1550297	1385292	37084898	9261792	8366764	1007138	9373902	10863580	spneumo_pangenome_k32.r_0.8.S_eulertigs.k_23.d_na.M_ones.C_bzip
spneumo_pangenome_k32	0.8	eulertigs	23	na	ones	xz	6608474	37084898	6880077	30204821	1550297	1385292	37084898	9261792	8366764	1354608	9721372	10863580	spneumo_pangenome_k32.r_0.8.S_eulertigs.k_23.d_na.M_ones.C_xz
spneumo_pangenome_k32	0.8	eulertigs	23	na	runsapprox	bzip	6608474	37084898	6880077	30204821	1550297	1385292	37084898	9261792	8366764	1007138	9373902	10863580	spneumo_pangenome_k32.r_0.8.S_eulertigs.k_23.d_na.M_runsapprox.C_bzip
spneumo_pangenome_k32	0.8	eulertigs	23	na	runsapprox	xz	6608474	37084898	6880077	30204821	1550297	1385292	37084898	9261792	8366764	1354608	9721372	10863580	spneumo_pangenome_k32.r_0.8.S_eulertigs.k_23.d_na.M_runsapprox.C_xz
spneumo_pangenome_k32	0.9	eulertigs	23	na	default	bzip	7434533	26141507	7434533	18706974	850317	850317	26141507	6470984	5875964	553806	6429770	7663724	spneumo_pangenome_k32.r_0.9.S_eulertigs.k_23.d_na.M_default.C_bzip
spneumo_pangenome_k32	0.9	eulertigs	23	na	default	xz	7434533	26141507	7434533	18706974	850317	850317	26141507	6470984	5875964	809948	6685912	7663724	spneumo_pangenome_k32.r_0.9.S_eulertigs.k_23.d_na.M_default.C_xz
spneumo_pangenome_k32	0.9	eulertigs	23	na	ones	bzip	7434533	26141507	7654724	18486783	950533	850317	26141507	6470984	5875964	743145	6619109	7794500	spneumo_pangenome_k32.r_0.9.S_eulertigs.k_23.d_na.M_ones.C_bzip
spneumo_pangenome_k32	0.9	eulertigs	23	na	ones	xz	7434533	26141507	7654724	18486783	950533	850317	26141507	6470984	5875964	990552	6866516	7794500	spneumo_pangenome_k32.r_0.9.S_eulertigs.k_23.d_na.M_ones.C_xz
spneumo_pangenome_k32	0.9	eulertigs	23	na	runsapprox	bzip	7434533	26141507	7654724	18486783	950533	850317	26141507	6470984	5875964	743145	6619109	7794500	spneumo_pangenome_k32.r_0.9.S_eulertigs.k_23.d_na.M_runsapprox.C_bzip
spneumo_pangenome_k32	0.9	eulertigs	23	na	runsapprox	xz	7434533	26141507	7654724	18486783	950533	850317	26141507	6470984	5875964	990552	6866516	7794500	spneumo_pangenome_k32.r_0.9.S_eulertigs.k_23.d_na.M_runsapprox.C_xz
spneumo_pangenome_k32	1.0	eulertigs	23	na	default	bzip	8260593	11861993	8260593	3601400	163700	163700	11861993	2654876	2520572	133797	2654369	3112276	spneumo_pangenome_k32.r_1.0.S_eulertigs.k_23.d_na.M_default.C_bzip
spneumo_pangenome_k32	1.0	eulertigs	23	na	default	xz	8260593	11861993	8260593	3601400	163700	163700	11861993	2654876	2520572	227888	2748460	3112276	spneumo_pangenome_k32.r_1.0.S_eulertigs.k_23.d_na.M_default.C_xz
spneumo_pangenome_k32	1.0	eulertigs	23	na	ones	bzip	8260593	11861993	8383323	3478670	163899	163700	11861993	2654876	2520572	181712	2702284	3122940	spneumo_pangenome_k32.r_1.0.S_eulertigs.k_23.d_na.M_ones.C_bzip
spneumo_pangenome_k32	1.0	eulertigs	23	na	ones	xz	8260593	11861993	8383323	3478670	163899	163700	11861993	2654876	2520572	280184	2800756	3122940	spneumo_pangenome_k32.r_1.0.S_eulertigs.k_23.d_na.M_ones.C_xz
spneumo_pangenome_k32	1.0	eulertigs	23	na	runsapprox	bzip	8260593	11861993	8383323	3478670	163899	163700	11861993	2654876	2520572	181712	2702284	3122940	spneumo_pangenome_k32.r_1.0.S_eulertigs.k_23.d_na.M_runsapprox.C_bzip
spneumo_pangenome_k32	1.0	eulertigs	23	na	runsapprox	xz	8260593	11861993	8383323	3478670	163899	163700	11861993	2654876	2520572	280184	2800756	3122940	spneumo_pangenome_k32.r_1.0.S_eulertigs.k_23.d_na.M_runsapprox.C_xz
spneumo_pangenome_k32	0.000000001	greedytigs	23	na	default	bzip	1	23	1	22	1	1	23	92	88	41	129	88	spneumo_pangenome_k32.r_0.000000001.S_greedytigs.k_23.d_na.M_default.C_bzip
spneumo_pangenome_k32	0.000000001	greedytigs	23	na	default	xz	1	23	1	22	1	1	23	92	88	76	164	88	spneumo_pangenome_k32.r_0.000000001.S_greedytigs.k_23.d_na.M_default.C_xz
spneumo_pangenome_k32	0.000000001	greedytigs	23	na	ones	bzip	1	23	1	22	1	1	23	92	88	41	129	88	spneumo_pangenome_k32.r_0.000000001.S_greedytigs.k_23.d_na.M_ones.C_bzip
spneumo_pangenome_k32	0.000000001	greedytigs	23	na	ones	xz	1	23	1	22	1	1	23	92	88	76	164	88	spneumo_pangenome_k32.r_0.000000001.S_greedytigs.k_23.d_na.M_ones.C_xz
spneumo_pangenome_k32	0.000000001	greedytigs	23	na	runsapprox	bzip	1	23	1	22	1	1	23	92	88	41	129	88	spneumo_pangenome_k32.r_0.000000001.S_greedytigs.k_23.d_na.M_runsapprox.C_bzip
spneumo_pangenome_k32	0.000000001	greedytigs	23	na	runsapprox	xz	1	23	1	22	1	1	23	92	88	76	164	88	spneumo_pangenome_k32.r_0.000000001.S_greedytigs.k_23.d_na.M_runsapprox.C_xz
spneumo_pangenome_k32	0.0001	greedytigs	23	na	default	bzip	826	18998	826	18172	826	826	18998	5672	5388	47	5435	5704	spneumo_pangenome_k32.r_0.0001.S_greedytigs.k_23.d_na.M_default.C_bzip
spneumo_pangenome_k32	0.0001	greedytigs	23	na	default	xz	826	18998	826	18172	826	826	18998	5672	5388	136	5524	5704	spneumo_pangenome_k32.r_0.0001.S_greedytigs.k_23.d_na.M_default.C_xz
spneumo_pangenome_k32	0.0001	greedytigs	23	na	ones	bzip	826	18998	826	18172	826	826	18998	5672	5388	47	5435	5704	spneumo_pangenome_k32.r_0.0001.S_greedytigs.k_23.d_na.M_ones.C_bzip
spneumo_pangenome_k32	0.0001	greedytigs	23	na	ones	xz	826	18998	826	18172	826	826	18998	5672	5388	136	5524	5704	spneumo_pangenome_k32.r_0.0001.S_greedytigs.k_23.d_na.M_ones.C_xz
spneumo_pangenome_k32	0.0001	greedytigs	23	na	runsapprox	bzip	826	18998	826	18172	826	826	18998	5672	5388	47	5435	5704	spneumo_pangenome_k32.r_0.0001.S_greedytigs.k_23.d_na.M_runsapprox.C_bzip
spneumo_pangenome_k32	0.0001	greedytigs	23	na	runsapprox	xz	826	18998	826	18172	826	826	18998	5672	5388	136	5524	5704	spneumo_pangenome_k32.r_0.0001.S_greedytigs.k_23.d_na.M_runsapprox.C_xz
spneumo_pangenome_k32	0.001	greedytigs	23	na	default	bzip	8260	189672	8260	181412	8246	8246	189672	53972	51240	77	51317	55216	spneumo_pangenome_k32.r_0.001.S_greedytigs.k_23.d_na.M_default.C_bzip
spneumo_pangenome_k32	0.001	greedytigs	23	na	default	xz	8260	189672	8260	181412	8246	8246	189672	53972	51240	232	51472	55216	spneumo_pangenome_k32.r_0.001.S_greedytigs.k_23.d_na.M_default.C_xz
spneumo_pangenome_k32	0.001	greedytigs	23	na	ones	bzip	8260	189672	8262	181410	8248	8246	189672	53972	51240	87	51327	55240	spneumo_pangenome_k32.r_0.001.S_greedytigs.k_23.d_na.M_ones.C_bzip
spneumo_pangenome_k32	0.001	greedytigs	23	na	ones	xz	8260	189672	8262	181410	8248	8246	189672	53972	51240	244	51484	55240	spneumo_pangenome_k32.r_0.001.S_greedytigs.k_23.d_na.M_ones.C_xz
spneumo_pangenome_k32	0.001	greedytigs	23	na	runsapprox	bzip	8260	189672	8262	181410	8248	8246	189672	53972	51240	87	51327	55240	spneumo_pangenome_k32.r_0.001.S_greedytigs.k_23.d_na.M_runsapprox.C_bzip
spneumo_pangenome_k32	0.001	greedytigs	23	na	runsapprox	xz	8260	189672	8262	181410	8248	8246	189672	53972	51240	244	51484	55240	spneumo_pangenome_k32.r_0.001.S_greedytigs.k_23.d_na.M_runsapprox.C_xz
spneumo_pangenome_k32	0.01	greedytigs	23	na	default	bzip	82605	1882183	82605	1799578	81799	81799	1882183	537800	487176	1456	488632	548312	spneumo_pangenome_k32.r_0.01.S_greedytigs.k_23.d_na.M_default.C_bzip
spneumo_pangenome_k32	0.01	greedytigs	23	na	default	xz	82605	1882183	82605	1799578	81799	81799	1882183	537800	487176	2700	489876	548312	spneumo_pangenome_k32.r_0.01.S_greedytigs.k_23.d_na.M_default.C_xz
spneumo_pangenome_k32	0.01	greedytigs	23	na	ones	bzip	82605	1882183	82748	1799435	81942	81799	1882183	537800	487176	1754	488930	548396	spneumo_pangenome_k32.r_0.01.S_greedytigs.k_23.d_na.M_ones.C_bzip
spneumo_pangenome_k32	0.01	greedytigs	23	na	ones	xz	82605	1882183	82748	1799435	81942	81799	1882183	537800	487176	3420	490596	548396	spneumo_pangenome_k32.r_0.01.S_greedytigs.k_23.d_na.M_ones.C_xz
spneumo_pangenome_k32	0.01	greedytigs	23	na	runsapprox	bzip	82605	1882183	82748	1799435	81942	81799	1882183	537800	487176	1754	488930	548396	spneumo_pangenome_k32.r_0.01.S_greedytigs.k_23.d_na.M_runsapprox.C_bzip
spneumo_pangenome_k32	0.01	greedytigs	23	na	runsapprox	xz	82605	1882183	82748	1799435	81942	81799	1882183	537800	487176	3420	490596	548396	spneumo_pangenome_k32.r_0.01.S_greedytigs.k_23.d_na.M_runsapprox.C_xz
spneumo_pangenome_k32	0.05	greedytigs	23	na	default	bzip	413029	9037293	413029	8624264	392012	392012	9037293	2504396	2242736	24854	2267590	2559492	spneumo_pangenome_k32.r_0.05.S_greedytigs.k_23.d_na.M_default.C_bzip
spneumo_pangenome_k32	0.05	greedytigs	23	na	default	xz	413029	9037293	413029	8624264	392012	392012	9037293	2504396	2242736	43452	2286188	2559492	spneumo_pangenome_k32.r_0.05.S_greedytigs.k_23.d_na.M_default.C_xz
spneumo_pangenome_k32	0.05	greedytigs	23	na	ones	bzip	413029	9037293	416995	8620298	395902	392012	9037293	2504396	2242736	31289	2274025	2561912	spneumo_pangenome_k32.r_0.05.S_greedytigs.k_23.d_na.M_ones.C_bzip
spneumo_pangenome_k32	0.05	greedytigs	23	na	ones	xz	413029	9037293	416995	8620298	395902	392012	9037293	2504396	2242736	57352	2300088	2561912	spneumo_pangenome_k32.r_0.05.S_greedytigs.k_23.d_na.M_ones.C_xz
spneumo_pangenome_k32	0.05	greedytigs	23	na	runsapprox	bzip	413029	9037293	416995	8620298	395902	392012	9037293	2504396	2242736	31289	2274025	2561912	spneumo_pangenome_k32.r_0.05.S_greedytigs.k_23.d_na.M_runsapprox.C_bzip
spneumo_pangenome_k32	0.05	greedytigs	23	na	runsapprox	xz	413029	9037293	416995	8620298	395902	392012	9037293	2504396	2242736	57352	2300088	2561912	spneumo_pangenome_k32.r_0.05.S_greedytigs.k_23.d_na.M_runsapprox.C_xz
spneumo_pangenome_k32	0.1	greedytigs	23	na	default	bzip	826059	17156483	826059	16330424	742292	742292	17156483	4638624	4148060	75226	4223286	4762560	spneumo_pangenome_k32.r_0.1.S_greedytigs.k_23.d_na.M_default.C_bzip
spneumo_pangenome_k32	0.1	greedytigs	23	na	default	xz	826059	17156483	826059	16330424	742292	742292	17156483	4638624	4148060	130436	4278496	4762560	spneumo_pangenome_k32.r_0.1.S_greedytigs.k_23.d_na.M_default.C_xz
spneumo_pangenome_k32	0.1	greedytigs	23	na	ones	bzip	826059	17156483	841472	16315011	757228	742292	17156483	4638624	4148060	97564	4245624	4772760	spneumo_pangenome_k32.r_0.1.S_greedytigs.k_23.d_na.M_ones.C_bzip
spneumo_pangenome_k32	0.1	greedytigs	23	na	ones	xz	826059	17156483	841472	16315011	757228	742292	17156483	4638624	4148060	175516	4323576	4772760	spneumo_pangenome_k32.r_0.1.S_greedytigs.k_23.d_na.M_ones.C_xz
spneumo_pangenome_k32	0.1	greedytigs	23	na	runsapprox	bzip	826059	17156483	841472	16315011	757228	742292	17156483	4638624	4148060	97564	4245624	4772760	spneumo_pangenome_k32.r_0.1.S_greedytigs.k_23.d_na.M_runsapprox.C_bzip
spneumo_pangenome_k32	0.1	greedytigs	23	na	runsapprox	xz	826059	17156483	841472	16315011	757228	742292	17156483	4638624	4148060	175516	4323576	4772760	spneumo_pangenome_k32.r_0.1.S_greedytigs.k_23.d_na.M_runsapprox.C_xz
spneumo_pangenome_k32	0.2	greedytigs	23	na	default	bzip	1652118	30628643	1652135	28976508	1317114	1317114	30628643	8045360	7203384	211499	7414883	8366160	spneumo_pangenome_k32.r_0.2.S_greedytigs.k_23.d_na.M_default.C_bzip
spneumo_pangenome_k32	0.2	greedytigs	23	na	default	xz	1652118	30628643	1652135	28976508	1317114	1317114	30628643	8045360	7203384	363140	7566524	8366160	spneumo_pangenome_k32.r_0.2.S_greedytigs.k_23.d_na.M_default.C_xz
spneumo_pangenome_k32	0.2	greedytigs	23	na	ones	bzip	1652118	30628643	1706859	28921784	1367924	1317114	30628643	8045360	7203384	281105	7484489	8407068	spneumo_pangenome_k32.r_0.2.S_greedytigs.k_23.d_na.M_ones.C_bzip
spneumo_pangenome_k32	0.2	greedytigs	23	na	ones	xz	1652118	30628643	1706859	28921784	1367924	1317114	30628643	8045360	7203384	491996	7695380	8407068	spneumo_pangenome_k32.r_0.2.S_greedytigs.k_23.d_na.M_ones.C_xz
spneumo_pangenome_k32	0.2	greedytigs	23	na	runsapprox	bzip	1652118	30628643	1706859	28921784	1367924	1317114	30628643	8045360	7203384	281105	7484489	8407068	spneumo_pangenome_k32.r_0.2.S_greedytigs.k_23.d_na.M_runsapprox.C_bzip
spneumo_pangenome_k32	0.2	greedytigs	23	na	runsapprox	xz	1652118	30628643	1706859	28921784	1367924	1317114	30628643	8045360	7203384	491996	7695380	8407068	spneumo_pangenome_k32.r_0.2.S_greedytigs.k_23.d_na.M_runsapprox.C_xz
spneumo_pangenome_k32	0.3	greedytigs	23	na	default	bzip	2478177	40476476	2478274	37998202	1727191	1727191	40476476	10441692	9359476	371708	9731184	10994056	spneumo_pangenome_k32.r_0.3.S_greedytigs.k_23.d_na.M_default.C_bzip
spneumo_pangenome_k32	0.3	greedytigs	23	na	default	xz	2478177	40476476	2478274	37998202	1727191	1727191	40476476	10441692	9359476	634756	9994232	10994056	spneumo_pangenome_k32.r_0.3.S_greedytigs.k_23.d_na.M_default.C_xz
spneumo_pangenome_k32	0.3	greedytigs	23	na	ones	bzip	2478177	40476476	2586674	37889802	1824055	1727191	40476476	10441692	9359476	499652	9859128	11075400	spneumo_pangenome_k32.r_0.3.S_greedytigs.k_23.d_na.M_ones.C_bzip
spneumo_pangenome_k32	0.3	greedytigs	23	na	ones	xz	2478177	40476476	2586674	37889802	1824055	1727191	40476476	10441692	9359476	843048	10202524	11075400	spneumo_pangenome_k32.r_0.3.S_greedytigs.k_23.d_na.M_ones.C_xz
spneumo_pangenome_k32	0.3	greedytigs	23	na	runsapprox	bzip	2478177	40476476	2586674	37889802	1824055	1727191	40476476	10441692	9359476	499652	9859128	11075400	spneumo_pangenome_k32.r_0.3.S_greedytigs.k_23.d_na.M_runsapprox.C_bzip
spneumo_pangenome_k32	0.3	greedytigs	23	na	runsapprox	xz	2478177	40476476	2586674	37889802	1824055	1727191	40476476	10441692	9359476	843048	10202524	11075400	spneumo_pangenome_k32.r_0.3.S_greedytigs.k_23.d_na.M_runsapprox.C_xz
spneumo_pangenome_k32	0.4	greedytigs	23	na	default	bzip	3304237	46772765	3304659	43468106	1975823	1975823	46772765	11875252	10658152	534238	11192390	12692216	spneumo_pangenome_k32.r_0.4.S_greedytigs.k_23.d_na.M_default.C_bzip
spneumo_pangenome_k32	0.4	greedytigs	23	na	default	xz	3304237	46772765	3304659	43468106	1975823	1975823	46772765	11875252	10658152	898020	11556172	12692216	spneumo_pangenome_k32.r_0.4.S_greedytigs.k_23.d_na.M_default.C_xz
spneumo_pangenome_k32	0.4	greedytigs	23	na	ones	bzip	3304237	46772765	3471933	43300832	2118411	1975823	46772765	11875252	10658152	722428	11380580	12812112	spneumo_pangenome_k32.r_0.4.S_greedytigs.k_23.d_na.M_ones.C_bzip
spneumo_pangenome_k32	0.4	greedytigs	23	na	ones	xz	3304237	46772765	3471933	43300832	2118411	1975823	46772765	11875252	10658152	1163268	11821420	12812112	spneumo_pangenome_k32.r_0.4.S_greedytigs.k_23.d_na.M_ones.C_xz
spneumo_pangenome_k32	0.4	greedytigs	23	na	runsapprox	bzip	3304237	46772765	3471933	43300832	2118411	1975823	46772765	11875252	10658152	722428	11380580	12812112	spneumo_pangenome_k32.r_0.4.S_greedytigs.k_23.d_na.M_runsapprox.C_bzip
spneumo_pangenome_k32	0.4	greedytigs	23	na	runsapprox	xz	3304237	46772765	3471933	43300832	2118411	1975823	46772765	11875252	10658152	1163268	11821420	12812112	spneumo_pangenome_k32.r_0.4.S_greedytigs.k_23.d_na.M_runsapprox.C_xz
spneumo_pangenome_k32	0.5	greedytigs	23	na	default	bzip	4130296	49524849	4131853	45392996	2063318	2063318	49524849	12489528	11236700	679065	11915765	13532564	spneumo_pangenome_k32.r_0.5.S_greedytigs.k_23.d_na.M_default.C_bzip
spneumo_pangenome_k32	0.5	greedytigs	23	na	default	xz	4130296	49524849	4131853	45392996	2063318	2063318	49524849	12489528	11236700	1110528	12347228	13532564	spneumo_pangenome_k32.r_0.5.S_greedytigs.k_23.d_na.M_default.C_xz
spneumo_pangenome_k32	0.5	greedytigs	23	na	ones	bzip	4130296	49524849	4352831	45172018	2242576	2063318	49524849	12489528	11236700	917784	12154484	13701864	spneumo_pangenome_k32.r_0.5.S_greedytigs.k_23.d_na.M_ones.C_bzip
spneumo_pangenome_k32	0.5	greedytigs	23	na	ones	xz	4130296	49524849	4352831	45172018	2242576	2063318	49524849	12489528	11236700	1406048	12642748	13701864	spneumo_pangenome_k32.r_0.5.S_greedytigs.k_23.d_na.M_ones.C_xz
spneumo_pangenome_k32	0.5	greedytigs	23	na	runsapprox	bzip	4130296	49524849	4352831	45172018	2242576	2063318	49524849	12489528	11236700	917784	12154484	13701864	spneumo_pangenome_k32.r_0.5.S_greedytigs.k_23.d_na.M_runsapprox.C_bzip
spneumo_pangenome_k32	0.5	greedytigs	23	na	runsapprox	xz	4130296	49524849	4352831	45172018	2242576	2063318	49524849	12489528	11236700	1406048	12642748	13701864	spneumo_pangenome_k32.r_0.5.S_greedytigs.k_23.d_na.M_runsapprox.C_xz
spneumo_pangenome_k32	0.6	greedytigs	23	na	default	bzip	4956355	48785110	4961616	43823494	1991977	1991977	48785110	12247248	11034880	782599	11817479	13496612	spneumo_pangenome_k32.r_0.6.S_greedytigs.k_23.d_na.M_default.C_bzip
spneumo_pangenome_k32	0.6	greedytigs	23	na	default	xz	4956355	48785110	4961616	43823494	1991977	1991977	48785110	12247248	11034880	1234880	12269760	13496612	spneumo_pangenome_k32.r_0.6.S_greedytigs.k_23.d_na.M_default.C_xz
spneumo_pangenome_k32	0.6	greedytigs	23	na	ones	bzip	4956355	48785110	5222740	43562370	2191028	1991977	48785110	12247248	11034880	1055919	12090799	13689000	spneumo_pangenome_k32.r_0.6.S_greedytigs.k_23.d_na.M_ones.C_bzip
spneumo_pangenome_k32	0.6	greedytigs	23	na	ones	xz	4956355	48785110	5222740	43562370	2191028	1991977	48785110	12247248	11034880	1536848	12571728	13689000	spneumo_pangenome_k32.r_0.6.S_greedytigs.k_23.d_na.M_ones.C_xz
spneumo_pangenome_k32	0.6	greedytigs	23	na	runsapprox	bzip	4956355	48785110	5222740	43562370	2191028	1991977	48785110	12247248	11034880	1055919	12090799	13689000	spneumo_pangenome_k32.r_0.6.S_greedytigs.k_23.d_na.M_runsapprox.C_bzip
spneumo_pangenome_k32	0.6	greedytigs	23	na	runsapprox	xz	4956355	48785110	5222740	43562370	2191028	1991977	48785110	12247248	11034880	1536848	12571728	13689000	spneumo_pangenome_k32.r_0.6.S_greedytigs.k_23.d_na.M_runsapprox.C_xz
spneumo_pangenome_k32	0.7	greedytigs	23	na	default	bzip	5782415	44536519	5798941	38737578	1760799	1760799	44536519	11156896	10069592	815267	10884859	12546244	spneumo_pangenome_k32.r_0.7.S_greedytigs.k_23.d_na.M_default.C_bzip
spneumo_pangenome_k32	0.7	greedytigs	23	na	default	xz	5782415	44536519	5798941	38737578	1760799	1760799	44536519	11156896	10069592	1239988	11309580	12546244	spneumo_pangenome_k32.r_0.7.S_greedytigs.k_23.d_na.M_default.C_xz
spneumo_pangenome_k32	0.7	greedytigs	23	na	ones	bzip	5782415	44536519	6075999	38460520	1956300	1760799	44536519	11156896	10069592	1094174	11163766	12752052	spneumo_pangenome_k32.r_0.7.S_greedytigs.k_23.d_na.M_ones.C_bzip
spneumo_pangenome_k32	0.7	greedytigs	23	na	ones	xz	5782415	44536519	6075999	38460520	1956300	1760799	44536519	11156896	10069592	1523776	11593368	12752052	spneumo_pangenome_k32.r_0.7.S_greedytigs.k_23.d_na.M_ones.C_xz
spneumo_pangenome_k32	0.7	greedytigs	23	na	runsapprox	bzip	5782415	44536519	6075999	38460520	1956300	1760799	44536519	11156896	10069592	1094174	11163766	12752052	spneumo_pangenome_k32.r_0.7.S_greedytigs.k_23.d_na.M_runsapprox.C_bzip
spneumo_pangenome_k32	0.7	greedytigs	23	na	runsapprox	xz	5782415	44536519	6075999	38460520	1956300	1760799	44536519	11156896	10069592	1523776	11593368	12752052	spneumo_pangenome_k32.r_0.7.S_greedytigs.k_23.d_na.M_runsapprox.C_xz
spneumo_pangenome_k32	0.8	greedytigs	23	na	default	bzip	6608474	36829748	6663634	30166114	1371187	1371187	36829748	9213820	8323344	747116	9070460	10613480	spneumo_pangenome_k32.r_0.8.S_greedytigs.k_23.d_na.M_default.C_bzip
spneumo_pangenome_k32	0.8	greedytigs	23	na	default	xz	6608474	36829748	6663634	30166114	1371187	1371187	36829748	9213820	8323344	1097028	9420372	10613480	spneumo_pangenome_k32.r_0.8.S_greedytigs.k_23.d_na.M_default.C_xz
spneumo_pangenome_k32	0.8	greedytigs	23	na	ones	bzip	6608474	36829748	6923935	29905813	1535969	1371187	36829748	9213820	8323344	995986	9319330	10806924	spneumo_pangenome_k32.r_0.8.S_greedytigs.k_23.d_na.M_ones.C_bzip
spneumo_pangenome_k32	0.8	greedytigs	23	na	ones	xz	6608474	36829748	6923935	29905813	1535969	1371187	36829748	9213820	8323344	1343768	9667112	10806924	spneumo_pangenome_k32.r_0.8.S_greedytigs.k_23.d_na.M_ones.C_xz
spneumo_pangenome_k32	0.8	greedytigs	23	na	runsapprox	bzip	6608474	36829748	6923935	29905813	1535969	1371187	36829748	9213820	8323344	995986	9319330	10806924	spneumo_pangenome_k32.r_0.8.S_greedytigs.k_23.d_na.M_runsapprox.C_bzip
spneumo_pangenome_k32	0.8	greedytigs	23	na	runsapprox	xz	6608474	36829748	6923935	29905813	1535969	1371187	36829748	9213820	8323344	1343768	9667112	10806924	spneumo_pangenome_k32.r_0.8.S_greedytigs.k_23.d_na.M_runsapprox.C_xz
spneumo_pangenome_k32	0.9	greedytigs	23	na	default	bzip	7434533	25614490	7643922	17970568	816844	816844	25614490	6343716	5765224	542212	6307436	7517280	spneumo_pangenome_k32.r_0.9.S_greedytigs.k_23.d_na.M_default.C_bzip
spneumo_pangenome_k32	0.9	greedytigs	23	na	default	xz	7434533	25614490	7643922	17970568	816844	816844	25614490	6343716	5765224	794408	6559632	7517280	spneumo_pangenome_k32.r_0.9.S_greedytigs.k_23.d_na.M_default.C_xz
spneumo_pangenome_k32	0.9	greedytigs	23	na	ones	bzip	7434533	25614490	7838889	17775601	917126	816844	25614490	6343716	5765224	714649	6479873	7644692	spneumo_pangenome_k32.r_0.9.S_greedytigs.k_23.d_na.M_ones.C_bzip
spneumo_pangenome_k32	0.9	greedytigs	23	na	ones	xz	7434533	25614490	7838889	17775601	917126	816844	25614490	6343716	5765224	962804	6728028	7644692	spneumo_pangenome_k32.r_0.9.S_greedytigs.k_23.d_na.M_ones.C_xz
spneumo_pangenome_k32	0.9	greedytigs	23	na	runsapprox	bzip	7434533	25614490	7838889	17775601	917126	816844	25614490	6343716	5765224	714649	6479873	7644692	spneumo_pangenome_k32.r_0.9.S_greedytigs.k_23.d_na.M_runsapprox.C_bzip
spneumo_pangenome_k32	0.9	greedytigs	23	na	runsapprox	xz	7434533	25614490	7838889	17775601	917126	816844	25614490	6343716	5765224	962804	6728028	7644692	spneumo_pangenome_k32.r_0.9.S_greedytigs.k_23.d_na.M_runsapprox.C_xz
spneumo_pangenome_k32	1.0	greedytigs	23	na	default	bzip	8260593	10753422	9170962	1582460	71930	71930	10753422	2205980	2132112	76452	2208564	2468268	spneumo_pangenome_k32.r_1.0.S_greedytigs.k_23.d_na.M_default.C_bzip
spneumo_pangenome_k32	1.0	greedytigs	23	na	default	xz	8260593	10753422	9170962	1582460	71930	71930	10753422	2205980	2132112	149372	2281484	2468268	spneumo_pangenome_k32.r_1.0.S_greedytigs.k_23.d_na.M_default.C_xz
spneumo_pangenome_k32	1.0	greedytigs	23	na	ones	bzip	8260593	10753422	9223202	1530220	71987	71930	10753422	2205980	2132112	95170	2227282	2469328	spneumo_pangenome_k32.r_1.0.S_greedytigs.k_23.d_na.M_ones.C_bzip
spneumo_pangenome_k32	1.0	greedytigs	23	na	ones	xz	8260593	10753422	9223202	1530220	71987	71930	10753422	2205980	2132112	171136	2303248	2469328	spneumo_pangenome_k32.r_1.0.S_greedytigs.k_23.d_na.M_ones.C_xz
spneumo_pangenome_k32	1.0	greedytigs	23	na	runsapprox	bzip	8260593	10753422	9223120	1530302	71930	71930	10753422	2205980	2132112	94970	2227082	2469848	spneumo_pangenome_k32.r_1.0.S_greedytigs.k_23.d_na.M_runsapprox.C_bzip
spneumo_pangenome_k32	1.0	greedytigs	23	na	runsapprox	xz	8260593	10753422	9223120	1530302	71930	71930	10753422	2205980	2132112	170996	2303108	2469848	spneumo_pangenome_k32.r_1.0.S_greedytigs.k_23.d_na.M_runsapprox.C_xz
spneumo_pangenome_k32	0.000000001	matchtigs	23	na	default	bzip	1	23	1	22	1	1	23	92	88	41	129	88	spneumo_pangenome_k32.r_0.000000001.S_matchtigs.k_23.d_na.M_default.C_bzip
spneumo_pangenome_k32	0.000000001	matchtigs	23	na	default	xz	1	23	1	22	1	1	23	92	88	76	164	88	spneumo_pangenome_k32.r_0.000000001.S_matchtigs.k_23.d_na.M_default.C_xz
spneumo_pangenome_k32	0.000000001	matchtigs	23	na	ones	bzip	1	23	1	22	1	1	23	92	88	41	129	88	spneumo_pangenome_k32.r_0.000000001.S_matchtigs.k_23.d_na.M_ones.C_bzip
spneumo_pangenome_k32	0.000000001	matchtigs	23	na	ones	xz	1	23	1	22	1	1	23	92	88	76	164	88	spneumo_pangenome_k32.r_0.000000001.S_matchtigs.k_23.d_na.M_ones.C_xz
spneumo_pangenome_k32	0.000000001	matchtigs	23	na	runsapprox	bzip	1	23	1	22	1	1	23	92	88	41	129	88	spneumo_pangenome_k32.r_0.000000001.S_matchtigs.k_23.d_na.M_runsapprox.C_bzip
spneumo_pangenome_k32	0.000000001	matchtigs	23	na	runsapprox	xz	1	23	1	22	1	1	23	92	88	76	164	88	spneumo_pangenome_k32.r_0.000000001.S_matchtigs.k_23.d_na.M_runsapprox.C_xz
spneumo_pangenome_k32	0.0001	matchtigs	23	na	default	bzip	826	18998	826	18172	826	826	18998	5672	5388	47	5435	5704	spneumo_pangenome_k32.r_0.0001.S_matchtigs.k_23.d_na.M_default.C_bzip
spneumo_pangenome_k32	0.0001	matchtigs	23	na	default	xz	826	18998	826	18172	826	826	18998	5672	5388	136	5524	5704	spneumo_pangenome_k32.r_0.0001.S_matchtigs.k_23.d_na.M_default.C_xz
spneumo_pangenome_k32	0.0001	matchtigs	23	na	ones	bzip	826	18998	826	18172	826	826	18998	5672	5388	47	5435	5704	spneumo_pangenome_k32.r_0.0001.S_matchtigs.k_23.d_na.M_ones.C_bzip
spneumo_pangenome_k32	0.0001	matchtigs	23	na	ones	xz	826	18998	826	18172	826	826	18998	5672	5388	136	5524	5704	spneumo_pangenome_k32.r_0.0001.S_matchtigs.k_23.d_na.M_ones.C_xz
spneumo_pangenome_k32	0.0001	matchtigs	23	na	runsapprox	bzip	826	18998	826	18172	826	826	18998	5672	5388	47	5435	5704	spneumo_pangenome_k32.r_0.0001.S_matchtigs.k_23.d_na.M_runsapprox.C_bzip
spneumo_pangenome_k32	0.0001	matchtigs	23	na	runsapprox	xz	826	18998	826	18172	826	826	18998	5672	5388	136	5524	5704	spneumo_pangenome_k32.r_0.0001.S_matchtigs.k_23.d_na.M_runsapprox.C_xz
spneumo_pangenome_k32	0.001	matchtigs	23	na	default	bzip	8260	189672	8260	181412	8246	8246	189672	53972	51240	77	51317	55216	spneumo_pangenome_k32.r_0.001.S_matchtigs.k_23.d_na.M_default.C_bzip
spneumo_pangenome_k32	0.001	matchtigs	23	na	default	xz	8260	189672	8260	181412	8246	8246	189672	53972	51240	232	51472	55216	spneumo_pangenome_k32.r_0.001.S_matchtigs.k_23.d_na.M_default.C_xz
spneumo_pangenome_k32	0.001	matchtigs	23	na	ones	bzip	8260	189672	8262	181410	8248	8246	189672	53972	51240	87	51327	55240	spneumo_pangenome_k32.r_0.001.S_matchtigs.k_23.d_na.M_ones.C_bzip
spneumo_pangenome_k32	0.001	matchtigs	23	na	ones	xz	8260	189672	8262	181410	8248	8246	189672	53972	51240	244	51484	55240	spneumo_pangenome_k32.r_0.001.S_matchtigs.k_23.d_na.M_ones.C_xz
spneumo_pangenome_k32	0.001	matchtigs	23	na	runsapprox	bzip	8260	189672	8262	181410	8248	8246	189672	53972	51240	87	51327	55240	spneumo_pangenome_k32.r_0.001.S_matchtigs.k_23.d_na.M_runsapprox.C_bzip
spneumo_pangenome_k32	0.001	matchtigs	23	na	runsapprox	xz	8260	189672	8262	181410	8248	8246	189672	53972	51240	244	51484	55240	spneumo_pangenome_k32.r_0.001.S_matchtigs.k_23.d_na.M_runsapprox.C_xz
spneumo_pangenome_k32	0.01	matchtigs	23	na	default	bzip	82605	1882183	82605	1799578	81799	81799	1882183	537800	487176	1456	488632	548312	spneumo_pangenome_k32.r_0.01.S_matchtigs.k_23.d_na.M_default.C_bzip
spneumo_pangenome_k32	0.01	matchtigs	23	na	default	xz	82605	1882183	82605	1799578	81799	81799	1882183	537800	487176	2700	489876	548312	spneumo_pangenome_k32.r_0.01.S_matchtigs.k_23.d_na.M_default.C_xz
spneumo_pangenome_k32	0.01	matchtigs	23	na	ones	bzip	82605	1882183	82748	1799435	81942	81799	1882183	537800	487176	1754	488930	548396	spneumo_pangenome_k32.r_0.01.S_matchtigs.k_23.d_na.M_ones.C_bzip
spneumo_pangenome_k32	0.01	matchtigs	23	na	ones	xz	82605	1882183	82748	1799435	81942	81799	1882183	537800	487176	3420	490596	548396	spneumo_pangenome_k32.r_0.01.S_matchtigs.k_23.d_na.M_ones.C_xz
spneumo_pangenome_k32	0.01	matchtigs	23	na	runsapprox	bzip	82605	1882183	82748	1799435	81942	81799	1882183	537800	487176	1754	488930	548396	spneumo_pangenome_k32.r_0.01.S_matchtigs.k_23.d_na.M_runsapprox.C_bzip
spneumo_pangenome_k32	0.01	matchtigs	23	na	runsapprox	xz	82605	1882183	82748	1799435	81942	81799	1882183	537800	487176	3420	490596	548396	spneumo_pangenome_k32.r_0.01.S_matchtigs.k_23.d_na.M_runsapprox.C_xz
spneumo_pangenome_k32	0.05	matchtigs	23	na	default	bzip	413029	9037293	413029	8624264	392012	392012	9037293	2504396	2242736	24854	2267590	2559492	spneumo_pangenome_k32.r_0.05.S_matchtigs.k_23.d_na.M_default.C_bzip
spneumo_pangenome_k32	0.05	matchtigs	23	na	default	xz	413029	9037293	413029	8624264	392012	392012	9037293	2504396	2242736	43452	2286188	2559492	spneumo_pangenome_k32.r_0.05.S_matchtigs.k_23.d_na.M_default.C_xz
spneumo_pangenome_k32	0.05	matchtigs	23	na	ones	bzip	413029	9037293	416995	8620298	395902	392012	9037293	2504396	2242736	31289	2274025	2561912	spneumo_pangenome_k32.r_0.05.S_matchtigs.k_23.d_na.M_ones.C_bzip
spneumo_pangenome_k32	0.05	matchtigs	23	na	ones	xz	413029	9037293	416995	8620298	395902	392012	9037293	2504396	2242736	57352	2300088	2561912	spneumo_pangenome_k32.r_0.05.S_matchtigs.k_23.d_na.M_ones.C_xz
spneumo_pangenome_k32	0.05	matchtigs	23	na	runsapprox	bzip	413029	9037293	416995	8620298	395902	392012	9037293	2504396	2242736	31289	2274025	2561912	spneumo_pangenome_k32.r_0.05.S_matchtigs.k_23.d_na.M_runsapprox.C_bzip
spneumo_pangenome_k32	0.05	matchtigs	23	na	runsapprox	xz	413029	9037293	416995	8620298	395902	392012	9037293	2504396	2242736	57352	2300088	2561912	spneumo_pangenome_k32.r_0.05.S_matchtigs.k_23.d_na.M_runsapprox.C_xz
spneumo_pangenome_k32	0.1	matchtigs	23	na	default	bzip	826059	17156483	826059	16330424	742292	742292	17156483	4638624	4148060	75226	4223286	4762560	spneumo_pangenome_k32.r_0.1.S_matchtigs.k_23.d_na.M_default.C_bzip
spneumo_pangenome_k32	0.1	matchtigs	23	na	default	xz	826059	17156483	826059	16330424	742292	742292	17156483	4638624	4148060	130436	4278496	4762560	spneumo_pangenome_k32.r_0.1.S_matchtigs.k_23.d_na.M_default.C_xz
spneumo_pangenome_k32	0.1	matchtigs	23	na	ones	bzip	826059	17156483	841472	16315011	757228	742292	17156483	4638624	4148060	97564	4245624	4772760	spneumo_pangenome_k32.r_0.1.S_matchtigs.k_23.d_na.M_ones.C_bzip
spneumo_pangenome_k32	0.1	matchtigs	23	na	ones	xz	826059	17156483	841472	16315011	757228	742292	17156483	4638624	4148060	175516	4323576	4772760	spneumo_pangenome_k32.r_0.1.S_matchtigs.k_23.d_na.M_ones.C_xz
spneumo_pangenome_k32	0.1	matchtigs	23	na	runsapprox	bzip	826059	17156483	841472	16315011	757228	742292	17156483	4638624	4148060	97564	4245624	4772760	spneumo_pangenome_k32.r_0.1.S_matchtigs.k_23.d_na.M_runsapprox.C_bzip
spneumo_pangenome_k32	0.1	matchtigs	23	na	runsapprox	xz	826059	17156483	841472	16315011	757228	742292	17156483	4638624	4148060	175516	4323576	4772760	spneumo_pangenome_k32.r_0.1.S_matchtigs.k_23.d_na.M_runsapprox.C_xz
spneumo_pangenome_k32	0.2	matchtigs	23	na	default	bzip	1652118	30628979	1652119	28976860	1317130	1317130	30628979	8046224	7202464	211492	7413956	8365504	spneumo_pangenome_k32.r_0.2.S_matchtigs.k_23.d_na.M_default.C_bzip
spneumo_pangenome_k32	0.2	matchtigs	23	na	default	xz	1652118	30628979	1652119	28976860	1317130	1317130	30628979	8046224	7202464	363136	7565600	8365504	spneumo_pangenome_k32.r_0.2.S_matchtigs.k_23.d_na.M_default.C_xz
spneumo_pangenome_k32	0.2	matchtigs	23	na	ones	bzip	1652118	30628979	1707207	28921772	1368373	1317130	30628979	8046224	7202464	281267	7483731	8405112	spneumo_pangenome_k32.r_0.2.S_matchtigs.k_23.d_na.M_ones.C_bzip
spneumo_pangenome_k32	0.2	matchtigs	23	na	ones	xz	1652118	30628979	1707207	28921772	1368373	1317130	30628979	8046224	7202464	493044	7695508	8405112	spneumo_pangenome_k32.r_0.2.S_matchtigs.k_23.d_na.M_ones.C_xz
spneumo_pangenome_k32	0.2	matchtigs	23	na	runsapprox	bzip	1652118	30628979	1707207	28921772	1368373	1317130	30628979	8046224	7202464	281267	7483731	8405112	spneumo_pangenome_k32.r_0.2.S_matchtigs.k_23.d_na.M_runsapprox.C_bzip
spneumo_pangenome_k32	0.2	matchtigs	23	na	runsapprox	xz	1652118	30628979	1707207	28921772	1368373	1317130	30628979	8046224	7202464	493044	7695508	8405112	spneumo_pangenome_k32.r_0.2.S_matchtigs.k_23.d_na.M_runsapprox.C_xz
spneumo_pangenome_k32	0.3	matchtigs	23	na	default	bzip	2478177	40478010	2478180	37999830	1727265	1727265	40478010	10438992	9349136	371786	9720922	10991764	spneumo_pangenome_k32.r_0.3.S_matchtigs.k_23.d_na.M_default.C_bzip
spneumo_pangenome_k32	0.3	matchtigs	23	na	default	xz	2478177	40478010	2478180	37999830	1727265	1727265	40478010	10438992	9349136	634348	9983484	10991764	spneumo_pangenome_k32.r_0.3.S_matchtigs.k_23.d_na.M_default.C_xz
spneumo_pangenome_k32	0.3	matchtigs	23	na	ones	bzip	2478177	40478010	2587332	37890678	1824604	1727265	40478010	10438992	9349136	500319	9849455	11076836	spneumo_pangenome_k32.r_0.3.S_matchtigs.k_23.d_na.M_ones.C_bzip
spneumo_pangenome_k32	0.3	matchtigs	23	na	ones	xz	2478177	40478010	2587332	37890678	1824604	1727265	40478010	10438992	9349136	843592	10192728	11076836	spneumo_pangenome_k32.r_0.3.S_matchtigs.k_23.d_na.M_ones.C_xz
spneumo_pangenome_k32	0.3	matchtigs	23	na	runsapprox	bzip	2478177	40478010	2587332	37890678	1824604	1727265	40478010	10438992	9349136	500319	9849455	11076836	spneumo_pangenome_k32.r_0.3.S_matchtigs.k_23.d_na.M_runsapprox.C_bzip
spneumo_pangenome_k32	0.3	matchtigs	23	na	runsapprox	xz	2478177	40478010	2587332	37890678	1824604	1727265	40478010	10438992	9349136	843592	10192728	11076836	spneumo_pangenome_k32.r_0.3.S_matchtigs.k_23.d_na.M_runsapprox.C_xz
spneumo_pangenome_k32	0.7	matchtigs	23	na	default	bzip	5782415	44633558	5784308	38849250	1765875	1765875	44633558	11178668	10079556	815386	10894942	12564116	spneumo_pangenome_k32.r_0.7.S_matchtigs.k_23.d_na.M_default.C_bzip
spneumo_pangenome_k32	0.7	matchtigs	23	na	default	xz	5782415	44633558	5784308	38849250	1765875	1765875	44633558	11178668	10079556	1240984	11320540	12564116	spneumo_pangenome_k32.r_0.7.S_matchtigs.k_23.d_na.M_default.C_xz
spneumo_pangenome_k32	0.7	matchtigs	23	na	ones	bzip	5782415	44633558	6068156	38565402	1963726	1765875	44633558	11178668	10079556	1099469	11179025	12776320	spneumo_pangenome_k32.r_0.7.S_matchtigs.k_23.d_na.M_ones.C_bzip
spneumo_pangenome_k32	0.7	matchtigs	23	na	ones	xz	5782415	44633558	6068156	38565402	1963726	1765875	44633558	11178668	10079556	1529468	11609024	12776320	spneumo_pangenome_k32.r_0.7.S_matchtigs.k_23.d_na.M_ones.C_xz
spneumo_pangenome_k32	0.7	matchtigs	23	na	runsapprox	bzip	5782415	44633558	6068156	38565402	1963726	1765875	44633558	11178668	10079556	1099469	11179025	12776320	spneumo_pangenome_k32.r_0.7.S_matchtigs.k_23.d_na.M_runsapprox.C_bzip
spneumo_pangenome_k32	0.7	matchtigs	23	na	runsapprox	xz	5782415	44633558	6068156	38565402	1963726	1765875	44633558	11178668	10079556	1529468	11609024	12776320	spneumo_pangenome_k32.r_0.7.S_matchtigs.k_23.d_na.M_runsapprox.C_xz
spneumo_pangenome_k32	0.8	matchtigs	23	na	default	bzip	6608474	37020960	6618126	30402834	1381947	1381947	37020960	9257384	8362708	749003	9111711	10651376	spneumo_pangenome_k32.r_0.8.S_matchtigs.k_23.d_na.M_default.C_bzip
spneumo_pangenome_k32	0.8	matchtigs	23	na	default	xz	6608474	37020960	6618126	30402834	1381947	1381947	37020960	9257384	8362708	1101208	9463916	10651376	spneumo_pangenome_k32.r_0.8.S_matchtigs.k_23.d_na.M_default.C_xz
spneumo_pangenome_k32	0.8	matchtigs	23	na	ones	bzip	6608474	37020960	6887620	30133340	1547112	1381947	37020960	9257384	8362708	1004522	9367230	10847240	spneumo_pangenome_k32.r_0.8.S_matchtigs.k_23.d_na.M_ones.C_bzip
spneumo_pangenome_k32	0.8	matchtigs	23	na	ones	xz	6608474	37020960	6887620	30133340	1547112	1381947	37020960	9257384	8362708	1352760	9715468	10847240	spneumo_pangenome_k32.r_0.8.S_matchtigs.k_23.d_na.M_ones.C_xz
spneumo_pangenome_k32	0.8	matchtigs	23	na	runsapprox	bzip	6608474	37020960	6887620	30133340	1547112	1381947	37020960	9257384	8362708	1004522	9367230	10847240	spneumo_pangenome_k32.r_0.8.S_matchtigs.k_23.d_na.M_runsapprox.C_bzip
spneumo_pangenome_k32	0.8	matchtigs	23	na	runsapprox	xz	6608474	37020960	6887620	30133340	1547112	1381947	37020960	9257384	8362708	1352760	9715468	10847240	spneumo_pangenome_k32.r_0.8.S_matchtigs.k_23.d_na.M_runsapprox.C_xz
spneumo_pangenome_k32	0.9	matchtigs	23	na	default	bzip	7434533	25871077	7500109	18370968	835044	835044	25871077	6422980	5828436	547428	6375864	7595532	spneumo_pangenome_k32.r_0.9.S_matchtigs.k_23.d_na.M_default.C_bzip
spneumo_pangenome_k32	0.9	matchtigs	23	na	default	xz	7434533	25871077	7500109	18370968	835044	835044	25871077	6422980	5828436	801960	6630396	7595532	spneumo_pangenome_k32.r_0.9.S_matchtigs.k_23.d_na.M_default.C_xz
spneumo_pangenome_k32	0.9	matchtigs	23	na	ones	bzip	7434533	25871077	7708636	18162441	935051	835044	25871077	6422980	5828436	730342	6558778	7724288	spneumo_pangenome_k32.r_0.9.S_matchtigs.k_23.d_na.M_ones.C_bzip
spneumo_pangenome_k32	0.9	matchtigs	23	na	ones	xz	7434533	25871077	7708636	18162441	935051	835044	25871077	6422980	5828436	976960	6805396	7724288	spneumo_pangenome_k32.r_0.9.S_matchtigs.k_23.d_na.M_ones.C_xz
spneumo_pangenome_k32	0.9	matchtigs	23	na	runsapprox	bzip	7434533	25871077	7708636	18162441	935051	835044	25871077	6422980	5828436	730342	6558778	7724288	spneumo_pangenome_k32.r_0.9.S_matchtigs.k_23.d_na.M_runsapprox.C_bzip
spneumo_pangenome_k32	0.9	matchtigs	23	na	runsapprox	xz	7434533	25871077	7708636	18162441	935051	835044	25871077	6422980	5828436	976960	6805396	7724288	spneumo_pangenome_k32.r_0.9.S_matchtigs.k_23.d_na.M_runsapprox.C_xz
spneumo_pangenome_k32	1.0	matchtigs	23	na	default	bzip	8260593	10608089	8933801	1674288	76104	76104	10608089	2238276	2155056	79887	2234943	2502964	spneumo_pangenome_k32.r_1.0.S_matchtigs.k_23.d_na.M_default.C_bzip
spneumo_pangenome_k32	1.0	matchtigs	23	na	default	xz	8260593	10608089	8933801	1674288	76104	76104	10608089	2238276	2155056	154016	2309072	2502964	spneumo_pangenome_k32.r_1.0.S_matchtigs.k_23.d_na.M_default.C_xz
spneumo_pangenome_k32	1.0	matchtigs	23	na	ones	bzip	8260593	10608089	8989580	1618509	76175	76104	10608089	2238276	2155056	99887	2254943	2504268	spneumo_pangenome_k32.r_1.0.S_matchtigs.k_23.d_na.M_ones.C_bzip
spneumo_pangenome_k32	1.0	matchtigs	23	na	ones	xz	8260593	10608089	8989580	1618509	76175	76104	10608089	2238276	2155056	176224	2331280	2504268	spneumo_pangenome_k32.r_1.0.S_matchtigs.k_23.d_na.M_ones.C_xz
spneumo_pangenome_k32	1.0	matchtigs	23	na	runsapprox	bzip	8260593	10608089	8989482	1618607	76104	76104	10608089	2238276	2155056	99575	2254631	2504372	spneumo_pangenome_k32.r_1.0.S_matchtigs.k_23.d_na.M_runsapprox.C_bzip
spneumo_pangenome_k32	1.0	matchtigs	23	na	runsapprox	xz	8260593	10608089	8989482	1618607	76104	76104	10608089	2238276	2155056	176040	2331096	2504372	spneumo_pangenome_k32.r_1.0.S_matchtigs.k_23.d_na.M_runsapprox.C_xz
spneumo_pangenome_k32	0.000000001	prophasm	23	na	default	bzip	1	23	1	22	1	1	23	92	88	41	129	88	spneumo_pangenome_k32.r_0.000000001.S_prophasm.k_23.d_na.M_default.C_bzip
spneumo_pangenome_k32	0.000000001	prophasm	23	na	default	xz	1	23	1	22	1	1	23	92	88	76	164	88	spneumo_pangenome_k32.r_0.000000001.S_prophasm.k_23.d_na.M_default.C_xz
spneumo_pangenome_k32	0.000000001	prophasm	23	na	ones	bzip	1	23	1	22	1	1	23	92	88	41	129	88	spneumo_pangenome_k32.r_0.000000001.S_prophasm.k_23.d_na.M_ones.C_bzip
spneumo_pangenome_k32	0.000000001	prophasm	23	na	ones	xz	1	23	1	22	1	1	23	92	88	76	164	88	spneumo_pangenome_k32.r_0.000000001.S_prophasm.k_23.d_na.M_ones.C_xz
spneumo_pangenome_k32	0.000000001	prophasm	23	na	runsapprox	bzip	1	23	1	22	1	1	23	92	88	41	129	88	spneumo_pangenome_k32.r_0.000000001.S_prophasm.k_23.d_na.M_runsapprox.C_bzip
spneumo_pangenome_k32	0.000000001	prophasm	23	na	runsapprox	xz	1	23	1	22	1	1	23	92	88	76	164	88	spneumo_pangenome_k32.r_0.000000001.S_prophasm.k_23.d_na.M_runsapprox.C_xz
spneumo_pangenome_k32	0.0001	prophasm	23	na	default	bzip	826	18998	826	18172	826	826	18998	6112	5540	47	5587	6272	spneumo_pangenome_k32.r_0.0001.S_prophasm.k_23.d_na.M_default.C_bzip
spneumo_pangenome_k32	0.0001	prophasm	23	na	default	xz	826	18998	826	18172	826	826	18998	6112	5540	136	5676	6272	spneumo_pangenome_k32.r_0.0001.S_prophasm.k_23.d_na.M_default.C_xz
spneumo_pangenome_k32	0.0001	prophasm	23	na	ones	bzip	826	18998	826	18172	826	826	18998	6112	5540	47	5587	6272	spneumo_pangenome_k32.r_0.0001.S_prophasm.k_23.d_na.M_ones.C_bzip
spneumo_pangenome_k32	0.0001	prophasm	23	na	ones	xz	826	18998	826	18172	826	826	18998	6112	5540	136	5676	6272	spneumo_pangenome_k32.r_0.0001.S_prophasm.k_23.d_na.M_ones.C_xz
spneumo_pangenome_k32	0.0001	prophasm	23	na	runsapprox	bzip	826	18998	826	18172	826	826	18998	6112	5540	47	5587	6272	spneumo_pangenome_k32.r_0.0001.S_prophasm.k_23.d_na.M_runsapprox.C_bzip
spneumo_pangenome_k32	0.0001	prophasm	23	na	runsapprox	xz	826	18998	826	18172	826	826	18998	6112	5540	136	5676	6272	spneumo_pangenome_k32.r_0.0001.S_prophasm.k_23.d_na.M_runsapprox.C_xz
spneumo_pangenome_k32	0.001	prophasm	23	na	default	bzip	8260	189672	8260	181412	8246	8246	189672	56844	51592	77	51669	58028	spneumo_pangenome_k32.r_0.001.S_prophasm.k_23.d_na.M_default.C_bzip
spneumo_pangenome_k32	0.001	prophasm	23	na	default	xz	8260	189672	8260	181412	8246	8246	189672	56844	51592	228	51820	58028	spneumo_pangenome_k32.r_0.001.S_prophasm.k_23.d_na.M_default.C_xz
spneumo_pangenome_k32	0.001	prophasm	23	na	ones	bzip	8260	189672	8265	181407	8251	8246	189672	56844	51592	95	51687	57936	spneumo_pangenome_k32.r_0.001.S_prophasm.k_23.d_na.M_ones.C_bzip
spneumo_pangenome_k32	0.001	prophasm	23	na	ones	xz	8260	189672	8265	181407	8251	8246	189672	56844	51592	260	51852	57936	spneumo_pangenome_k32.r_0.001.S_prophasm.k_23.d_na.M_ones.C_xz
spneumo_pangenome_k32	0.001	prophasm	23	na	runsapprox	bzip	8260	189672	8265	181407	8251	8246	189672	56844	51592	95	51687	57936	spneumo_pangenome_k32.r_0.001.S_prophasm.k_23.d_na.M_runsapprox.C_bzip
spneumo_pangenome_k32	0.001	prophasm	23	na	runsapprox	xz	8260	189672	8265	181407	8251	8246	189672	56844	51592	260	51852	57936	spneumo_pangenome_k32.r_0.001.S_prophasm.k_23.d_na.M_runsapprox.C_xz
spneumo_pangenome_k32	0.01	prophasm	23	na	default	bzip	82605	1882183	82605	1799578	81799	81799	1882183	546040	490332	1453	491785	554292	spneumo_pangenome_k32.r_0.01.S_prophasm.k_23.d_na.M_default.C_bzip
spneumo_pangenome_k32	0.01	prophasm	23	na	default	xz	82605	1882183	82605	1799578	81799	81799	1882183	546040	490332	2688	493020	554292	spneumo_pangenome_k32.r_0.01.S_prophasm.k_23.d_na.M_default.C_xz
spneumo_pangenome_k32	0.01	prophasm	23	na	ones	bzip	82605	1882183	82775	1799408	81969	81799	1882183	546040	490332	1797	492129	554256	spneumo_pangenome_k32.r_0.01.S_prophasm.k_23.d_na.M_ones.C_bzip
spneumo_pangenome_k32	0.01	prophasm	23	na	ones	xz	82605	1882183	82775	1799408	81969	81799	1882183	546040	490332	3512	493844	554256	spneumo_pangenome_k32.r_0.01.S_prophasm.k_23.d_na.M_ones.C_xz
spneumo_pangenome_k32	0.01	prophasm	23	na	runsapprox	bzip	82605	1882183	82775	1799408	81969	81799	1882183	546040	490332	1797	492129	554256	spneumo_pangenome_k32.r_0.01.S_prophasm.k_23.d_na.M_runsapprox.C_bzip
spneumo_pangenome_k32	0.01	prophasm	23	na	runsapprox	xz	82605	1882183	82775	1799408	81969	81799	1882183	546040	490332	3512	493844	554256	spneumo_pangenome_k32.r_0.01.S_prophasm.k_23.d_na.M_runsapprox.C_xz
spneumo_pangenome_k32	0.05	prophasm	23	na	default	bzip	413029	9037293	413029	8624264	392012	392012	9037293	2537432	2279464	23366	2302830	2590820	spneumo_pangenome_k32.r_0.05.S_prophasm.k_23.d_na.M_default.C_bzip
spneumo_pangenome_k32	0.05	prophasm	23	na	default	xz	413029	9037293	413029	8624264	392012	392012	9037293	2537432	2279464	40984	2320448	2590820	spneumo_pangenome_k32.r_0.05.S_prophasm.k_23.d_na.M_default.C_xz
spneumo_pangenome_k32	0.05	prophasm	23	na	ones	bzip	413029	9037293	417202	8620091	396110	392012	9037293	2537432	2279464	30209	2309673	2593492	spneumo_pangenome_k32.r_0.05.S_prophasm.k_23.d_na.M_ones.C_bzip
spneumo_pangenome_k32	0.05	prophasm	23	na	ones	xz	413029	9037293	417202	8620091	396110	392012	9037293	2537432	2279464	55896	2335360	2593492	spneumo_pangenome_k32.r_0.05.S_prophasm.k_23.d_na.M_ones.C_xz
spneumo_pangenome_k32	0.05	prophasm	23	na	runsapprox	bzip	413029	9037293	417202	8620091	396110	392012	9037293	2537432	2279464	30209	2309673	2593492	spneumo_pangenome_k32.r_0.05.S_prophasm.k_23.d_na.M_runsapprox.C_bzip
spneumo_pangenome_k32	0.05	prophasm	23	na	runsapprox	xz	413029	9037293	417202	8620091	396110	392012	9037293	2537432	2279464	55896	2335360	2593492	spneumo_pangenome_k32.r_0.05.S_prophasm.k_23.d_na.M_runsapprox.C_xz
spneumo_pangenome_k32	0.1	prophasm	23	na	default	bzip	826059	17156483	826059	16330424	742292	742292	17156483	4708952	4228380	70296	4298676	4835736	spneumo_pangenome_k32.r_0.1.S_prophasm.k_23.d_na.M_default.C_bzip
spneumo_pangenome_k32	0.1	prophasm	23	na	default	xz	826059	17156483	826059	16330424	742292	742292	17156483	4708952	4228380	121688	4350068	4835736	spneumo_pangenome_k32.r_0.1.S_prophasm.k_23.d_na.M_default.C_xz
spneumo_pangenome_k32	0.1	prophasm	23	na	ones	bzip	826059	17156483	841900	16314583	757572	742292	17156483	4708952	4228380	93327	4321707	4845884	spneumo_pangenome_k32.r_0.1.S_prophasm.k_23.d_na.M_ones.C_bzip
spneumo_pangenome_k32	0.1	prophasm	23	na	ones	xz	826059	17156483	841900	16314583	757572	742292	17156483	4708952	4228380	169228	4397608	4845884	spneumo_pangenome_k32.r_0.1.S_prophasm.k_23.d_na.M_ones.C_xz
spneumo_pangenome_k32	0.1	prophasm	23	na	runsapprox	bzip	826059	17156483	841900	16314583	757572	742292	17156483	4708952	4228380	93327	4321707	4845884	spneumo_pangenome_k32.r_0.1.S_prophasm.k_23.d_na.M_runsapprox.C_bzip
spneumo_pangenome_k32	0.1	prophasm	23	na	runsapprox	xz	826059	17156483	841900	16314583	757572	742292	17156483	4708952	4228380	169228	4397608	4845884	spneumo_pangenome_k32.r_0.1.S_prophasm.k_23.d_na.M_runsapprox.C_xz
spneumo_pangenome_k32	0.2	prophasm	23	na	default	bzip	1652118	30629000	1652118	28976882	1317131	1317131	30629000	8128916	7307196	197262	7504458	8454328	spneumo_pangenome_k32.r_0.2.S_prophasm.k_23.d_na.M_default.C_bzip
spneumo_pangenome_k32	0.2	prophasm	23	na	default	xz	1652118	30629000	1652118	28976882	1317131	1317131	30629000	8128916	7307196	339472	7646668	8454328	spneumo_pangenome_k32.r_0.2.S_prophasm.k_23.d_na.M_default.C_xz
spneumo_pangenome_k32	0.2	prophasm	23	na	ones	bzip	1652118	30629000	1709332	28919668	1370456	1317131	30629000	8128916	7307196	270371	7577567	8496288	spneumo_pangenome_k32.r_0.2.S_prophasm.k_23.d_na.M_ones.C_bzip
spneumo_pangenome_k32	0.2	prophasm	23	na	ones	xz	1652118	30629000	1709332	28919668	1370456	1317131	30629000	8128916	7307196	476952	7784148	8496288	spneumo_pangenome_k32.r_0.2.S_prophasm.k_23.d_na.M_ones.C_xz
spneumo_pangenome_k32	0.2	prophasm	23	na	runsapprox	bzip	1652118	30629000	1709332	28919668	1370456	1317131	30629000	8128916	7307196	270371	7577567	8496288	spneumo_pangenome_k32.r_0.2.S_prophasm.k_23.d_na.M_runsapprox.C_bzip
spneumo_pangenome_k32	0.2	prophasm	23	na	runsapprox	xz	1652118	30629000	1709332	28919668	1370456	1317131	30629000	8128916	7307196	476952	7784148	8496288	spneumo_pangenome_k32.r_0.2.S_prophasm.k_23.d_na.M_runsapprox.C_xz
spneumo_pangenome_k32	0.3	prophasm	23	na	default	bzip	2478177	40478051	2478177	37999874	1727267	1727267	40478051	10487840	9439568	345872	9785440	11048228	spneumo_pangenome_k32.r_0.3.S_prophasm.k_23.d_na.M_default.C_bzip
spneumo_pangenome_k32	0.3	prophasm	23	na	default	xz	2478177	40478051	2478177	37999874	1727267	1727267	40478051	10487840	9439568	588248	10027816	11048228	spneumo_pangenome_k32.r_0.3.S_prophasm.k_23.d_na.M_default.C_xz
spneumo_pangenome_k32	0.3	prophasm	23	na	ones	bzip	2478177	40478051	2590927	37887124	1827744	1727267	40478051	10487840	9439568	480037	9919605	11136436	spneumo_pangenome_k32.r_0.3.S_prophasm.k_23.d_na.M_ones.C_bzip
spneumo_pangenome_k32	0.3	prophasm	23	na	ones	xz	2478177	40478051	2590927	37887124	1827744	1727267	40478051	10487840	9439568	811020	10250588	11136436	spneumo_pangenome_k32.r_0.3.S_prophasm.k_23.d_na.M_ones.C_xz
spneumo_pangenome_k32	0.3	prophasm	23	na	runsapprox	bzip	2478177	40478051	2590927	37887124	1827744	1727267	40478051	10487840	9439568	480037	9919605	11136436	spneumo_pangenome_k32.r_0.3.S_prophasm.k_23.d_na.M_runsapprox.C_bzip
spneumo_pangenome_k32	0.3	prophasm	23	na	runsapprox	xz	2478177	40478051	2590927	37887124	1827744	1727267	40478051	10487840	9439568	811020	10250588	11136436	spneumo_pangenome_k32.r_0.3.S_prophasm.k_23.d_na.M_runsapprox.C_xz
spneumo_pangenome_k32	0.4	prophasm	23	na	default	bzip	3304237	46778723	3304237	43474486	1976113	1976113	46778723	11915544	10725240	495446	11220686	12725192	spneumo_pangenome_k32.r_0.4.S_prophasm.k_23.d_na.M_default.C_bzip
spneumo_pangenome_k32	0.4	prophasm	23	na	default	xz	3304237	46778723	3304237	43474486	1976113	1976113	46778723	11915544	10725240	821136	11546376	12725192	spneumo_pangenome_k32.r_0.4.S_prophasm.k_23.d_na.M_default.C_xz
spneumo_pangenome_k32	0.4	prophasm	23	na	ones	bzip	3304237	46778723	3478039	43300684	2124103	1976113	46778723	11915544	10725240	691484	11416724	12859984	spneumo_pangenome_k32.r_0.4.S_prophasm.k_23.d_na.M_ones.C_bzip
spneumo_pangenome_k32	0.4	prophasm	23	na	ones	xz	3304237	46778723	3478039	43300684	2124103	1976113	46778723	11915544	10725240	1112264	11837504	12859984	spneumo_pangenome_k32.r_0.4.S_prophasm.k_23.d_na.M_ones.C_xz
spneumo_pangenome_k32	0.4	prophasm	23	na	runsapprox	bzip	3304237	46778723	3478039	43300684	2124103	1976113	46778723	11915544	10725240	691484	11416724	12859984	spneumo_pangenome_k32.r_0.4.S_prophasm.k_23.d_na.M_runsapprox.C_bzip
spneumo_pangenome_k32	0.4	prophasm	23	na	runsapprox	xz	3304237	46778723	3478039	43300684	2124103	1976113	46778723	11915544	10725240	1112264	11837504	12859984	spneumo_pangenome_k32.r_0.4.S_prophasm.k_23.d_na.M_runsapprox.C_xz
spneumo_pangenome_k32	0.5	prophasm	23	na	default	bzip	4130296	49543290	4130296	45412994	2064227	2064227	49543290	12458576	11238176	625535	11863711	13526148	spneumo_pangenome_k32.r_0.5.S_prophasm.k_23.d_na.M_default.C_bzip
spneumo_pangenome_k32	0.5	prophasm	23	na	default	xz	4130296	49543290	4130296	45412994	2064227	2064227	49543290	12458576	11238176	1004896	12243072	13526148	spneumo_pangenome_k32.r_0.5.S_prophasm.k_23.d_na.M_default.C_xz
spneumo_pangenome_k32	0.5	prophasm	23	na	ones	bzip	4130296	49543290	4359894	45183396	2249787	2064227	49543290	12458576	11238176	874041	12112217	13702564	spneumo_pangenome_k32.r_0.5.S_prophasm.k_23.d_na.M_ones.C_bzip
spneumo_pangenome_k32	0.5	prophasm	23	na	ones	xz	4130296	49543290	4359894	45183396	2249787	2064227	49543290	12458576	11238176	1336904	12575080	13702564	spneumo_pangenome_k32.r_0.5.S_prophasm.k_23.d_na.M_ones.C_xz
spneumo_pangenome_k32	0.5	prophasm	23	na	runsapprox	bzip	4130296	49543290	4359894	45183396	2249787	2064227	49543290	12458576	11238176	874041	12112217	13702564	spneumo_pangenome_k32.r_0.5.S_prophasm.k_23.d_na.M_runsapprox.C_bzip
spneumo_pangenome_k32	0.5	prophasm	23	na	runsapprox	xz	4130296	49543290	4359894	45183396	2249787	2064227	49543290	12458576	11238176	1336904	12575080	13702564	spneumo_pangenome_k32.r_0.5.S_prophasm.k_23.d_na.M_runsapprox.C_xz
spneumo_pangenome_k32	0.6	prophasm	23	na	default	bzip	4956355	48833441	4956355	43877086	1994413	1994413	48833441	12180580	11002112	712832	11714944	13460124	spneumo_pangenome_k32.r_0.6.S_prophasm.k_23.d_na.M_default.C_bzip
spneumo_pangenome_k32	0.6	prophasm	23	na	default	xz	4956355	48833441	4956355	43877086	1994413	1994413	48833441	12180580	11002112	1111616	12113728	13460124	spneumo_pangenome_k32.r_0.6.S_prophasm.k_23.d_na.M_default.C_xz
spneumo_pangenome_k32	0.6	prophasm	23	na	ones	bzip	4956355	48833441	5226967	43606474	2199174	1994413	48833441	12180580	11002112	995242	11997354	13664168	spneumo_pangenome_k32.r_0.6.S_prophasm.k_23.d_na.M_ones.C_bzip
spneumo_pangenome_k32	0.6	prophasm	23	na	ones	xz	4956355	48833441	5226967	43606474	2199174	1994413	48833441	12180580	11002112	1454184	12456296	13664168	spneumo_pangenome_k32.r_0.6.S_prophasm.k_23.d_na.M_ones.C_xz
spneumo_pangenome_k32	0.6	prophasm	23	na	runsapprox	bzip	4956355	48833441	5226967	43606474	2199174	1994413	48833441	12180580	11002112	995242	11997354	13664168	spneumo_pangenome_k32.r_0.6.S_prophasm.k_23.d_na.M_runsapprox.C_bzip
spneumo_pangenome_k32	0.6	prophasm	23	na	runsapprox	xz	4956355	48833441	5226967	43606474	2199174	1994413	48833441	12180580	11002112	1454184	12456296	13664168	spneumo_pangenome_k32.r_0.6.S_prophasm.k_23.d_na.M_runsapprox.C_xz
spneumo_pangenome_k32	0.7	prophasm	23	na	default	bzip	5782415	44651619	5782415	38869204	1766782	1766782	44651619	11090296	10038496	733658	10772154	12522628	spneumo_pangenome_k32.r_0.7.S_prophasm.k_23.d_na.M_default.C_bzip
spneumo_pangenome_k32	0.7	prophasm	23	na	default	xz	5782415	44651619	5782415	38869204	1766782	1766782	44651619	11090296	10038496	1117564	11156060	12522628	spneumo_pangenome_k32.r_0.7.S_prophasm.k_23.d_na.M_default.C_xz
spneumo_pangenome_k32	0.7	prophasm	23	na	ones	bzip	5782415	44651619	6070980	38580639	1967077	1766782	44651619	11090296	10038496	1022664	11061160	12724364	spneumo_pangenome_k32.r_0.7.S_prophasm.k_23.d_na.M_ones.C_bzip
spneumo_pangenome_k32	0.7	prophasm	23	na	ones	xz	5782415	44651619	6070980	38580639	1967077	1766782	44651619	11090296	10038496	1443716	11482212	12724364	spneumo_pangenome_k32.r_0.7.S_prophasm.k_23.d_na.M_ones.C_xz
spneumo_pangenome_k32	0.7	prophasm	23	na	runsapprox	bzip	5782415	44651619	6070980	38580639	1967077	1766782	44651619	11090296	10038496	1022664	11061160	12724364	spneumo_pangenome_k32.r_0.7.S_prophasm.k_23.d_na.M_runsapprox.C_bzip
spneumo_pangenome_k32	0.7	prophasm	23	na	runsapprox	xz	5782415	44651619	6070980	38580639	1967077	1766782	44651619	11090296	10038496	1443716	11482212	12724364	spneumo_pangenome_k32.r_0.7.S_prophasm.k_23.d_na.M_runsapprox.C_xz
spneumo_pangenome_k32	0.8	prophasm	23	na	default	bzip	6608474	37084964	6608474	30476490	1385295	1385295	37084964	9178588	8315500	666522	8982022	10621360	spneumo_pangenome_k32.r_0.8.S_prophasm.k_23.d_na.M_default.C_bzip
spneumo_pangenome_k32	0.8	prophasm	23	na	default	xz	6608474	37084964	6608474	30476490	1385295	1385295	37084964	9178588	8315500	1007744	9323244	10621360	spneumo_pangenome_k32.r_0.8.S_prophasm.k_23.d_na.M_default.C_xz
spneumo_pangenome_k32	0.8	prophasm	23	na	ones	bzip	6608474	37084964	6883859	30201105	1552053	1385295	37084964	9178588	8315500	927706	9243206	10809440	spneumo_pangenome_k32.r_0.8.S_prophasm.k_23.d_na.M_ones.C_bzip
spneumo_pangenome_k32	0.8	prophasm	23	na	ones	xz	6608474	37084964	6883859	30201105	1552053	1385295	37084964	9178588	8315500	1285348	9600848	10809440	spneumo_pangenome_k32.r_0.8.S_prophasm.k_23.d_na.M_ones.C_xz
spneumo_pangenome_k32	0.8	prophasm	23	na	runsapprox	bzip	6608474	37084964	6883859	30201105	1552053	1385295	37084964	9178588	8315500	927706	9243206	10809440	spneumo_pangenome_k32.r_0.8.S_prophasm.k_23.d_na.M_runsapprox.C_bzip
spneumo_pangenome_k32	0.8	prophasm	23	na	runsapprox	xz	6608474	37084964	6883859	30201105	1552053	1385295	37084964	9178588	8315500	1285348	9600848	10809440	spneumo_pangenome_k32.r_0.8.S_prophasm.k_23.d_na.M_runsapprox.C_xz
spneumo_pangenome_k32	0.9	prophasm	23	na	default	bzip	7434533	26141705	7434533	18707172	850326	850326	26141705	6406832	5840904	489473	6330377	7606708	spneumo_pangenome_k32.r_0.9.S_prophasm.k_23.d_na.M_default.C_bzip
spneumo_pangenome_k32	0.9	prophasm	23	na	default	xz	7434533	26141705	7434533	18707172	850326	850326	26141705	6406832	5840904	755088	6595992	7606708	spneumo_pangenome_k32.r_0.9.S_prophasm.k_23.d_na.M_default.C_xz
spneumo_pangenome_k32	0.9	prophasm	23	na	ones	bzip	7434533	26141705	7657997	18483708	951668	850326	26141705	6406832	5840904	680542	6521446	7740928	spneumo_pangenome_k32.r_0.9.S_prophasm.k_23.d_na.M_ones.C_bzip
spneumo_pangenome_k32	0.9	prophasm	23	na	ones	xz	7434533	26141705	7657997	18483708	951668	850326	26141705	6406832	5840904	943920	6784824	7740928	spneumo_pangenome_k32.r_0.9.S_prophasm.k_23.d_na.M_ones.C_xz
spneumo_pangenome_k32	0.9	prophasm	23	na	runsapprox	bzip	7434533	26141705	7657997	18483708	951668	850326	26141705	6406832	5840904	680542	6521446	7740928	spneumo_pangenome_k32.r_0.9.S_prophasm.k_23.d_na.M_runsapprox.C_bzip
spneumo_pangenome_k32	0.9	prophasm	23	na	runsapprox	xz	7434533	26141705	7657997	18483708	951668	850326	26141705	6406832	5840904	943920	6784824	7740928	spneumo_pangenome_k32.r_0.9.S_prophasm.k_23.d_na.M_runsapprox.C_xz
spneumo_pangenome_k32	1.0	prophasm	23	na	default	bzip	8260593	11862411	8260593	3601818	163719	163719	11862411	2511168	2412760	119996	2532756	3036512	spneumo_pangenome_k32.r_1.0.S_prophasm.k_23.d_na.M_default.C_bzip
spneumo_pangenome_k32	1.0	prophasm	23	na	default	xz	8260593	11862411	8260593	3601818	163719	163719	11862411	2511168	2412760	199848	2612608	3036512	spneumo_pangenome_k32.r_1.0.S_prophasm.k_23.d_na.M_default.C_xz
spneumo_pangenome_k32	1.0	prophasm	23	na	ones	bzip	8260593	11862411	8385002	3477409	163894	163719	11862411	2511168	2412760	169597	2582357	3049380	spneumo_pangenome_k32.r_1.0.S_prophasm.k_23.d_na.M_ones.C_bzip
spneumo_pangenome_k32	1.0	prophasm	23	na	ones	xz	8260593	11862411	8385002	3477409	163894	163719	11862411	2511168	2412760	255312	2668072	3049380	spneumo_pangenome_k32.r_1.0.S_prophasm.k_23.d_na.M_ones.C_xz
spneumo_pangenome_k32	1.0	prophasm	23	na	runsapprox	bzip	8260593	11862411	8385002	3477409	163894	163719	11862411	2511168	2412760	169597	2582357	3049380	spneumo_pangenome_k32.r_1.0.S_prophasm.k_23.d_na.M_runsapprox.C_bzip
spneumo_pangenome_k32	1.0	prophasm	23	na	runsapprox	xz	8260593	11862411	8385002	3477409	163894	163719	11862411	2511168	2412760	255312	2668072	3049380	spneumo_pangenome_k32.r_1.0.S_prophasm.k_23.d_na.M_runsapprox.C_xz
spneumo_pangenome_k32	0.000000001	eulertigs	31	na	default	bzip	1	31	1	30	1	1	31	96	96	41	137	96	spneumo_pangenome_k32.r_0.000000001.S_eulertigs.k_31.d_na.M_default.C_bzip
spneumo_pangenome_k32	0.000000001	eulertigs	31	na	default	xz	1	31	1	30	1	1	31	96	96	76	172	96	spneumo_pangenome_k32.r_0.000000001.S_eulertigs.k_31.d_na.M_default.C_xz
spneumo_pangenome_k32	0.000000001	eulertigs	31	na	ones	bzip	1	31	1	30	1	1	31	96	96	41	137	96	spneumo_pangenome_k32.r_0.000000001.S_eulertigs.k_31.d_na.M_ones.C_bzip
spneumo_pangenome_k32	0.000000001	eulertigs	31	na	ones	xz	1	31	1	30	1	1	31	96	96	76	172	96	spneumo_pangenome_k32.r_0.000000001.S_eulertigs.k_31.d_na.M_ones.C_xz
spneumo_pangenome_k32	0.000000001	eulertigs	31	na	runsapprox	bzip	1	31	1	30	1	1	31	96	96	41	137	96	spneumo_pangenome_k32.r_0.000000001.S_eulertigs.k_31.d_na.M_runsapprox.C_bzip
spneumo_pangenome_k32	0.000000001	eulertigs	31	na	runsapprox	xz	1	31	1	30	1	1	31	96	96	76	172	96	spneumo_pangenome_k32.r_0.000000001.S_eulertigs.k_31.d_na.M_runsapprox.C_xz
spneumo_pangenome_k32	0.0001	eulertigs	31	na	default	bzip	962	29822	962	28860	962	962	29822	8684	8348	47	8395	8732	spneumo_pangenome_k32.r_0.0001.S_eulertigs.k_31.d_na.M_default.C_bzip
spneumo_pangenome_k32	0.0001	eulertigs	31	na	default	xz	962	29822	962	28860	962	962	29822	8684	8348	144	8492	8732	spneumo_pangenome_k32.r_0.0001.S_eulertigs.k_31.d_na.M_default.C_xz
spneumo_pangenome_k32	0.0001	eulertigs	31	na	ones	bzip	962	29822	962	28860	962	962	29822	8684	8348	47	8395	8732	spneumo_pangenome_k32.r_0.0001.S_eulertigs.k_31.d_na.M_ones.C_bzip
spneumo_pangenome_k32	0.0001	eulertigs	31	na	ones	xz	962	29822	962	28860	962	962	29822	8684	8348	144	8492	8732	spneumo_pangenome_k32.r_0.0001.S_eulertigs.k_31.d_na.M_ones.C_xz
spneumo_pangenome_k32	0.0001	eulertigs	31	na	runsapprox	bzip	962	29822	962	28860	962	962	29822	8684	8348	47	8395	8732	spneumo_pangenome_k32.r_0.0001.S_eulertigs.k_31.d_na.M_runsapprox.C_bzip
spneumo_pangenome_k32	0.0001	eulertigs	31	na	runsapprox	xz	962	29822	962	28860	962	962	29822	8684	8348	144	8492	8732	spneumo_pangenome_k32.r_0.0001.S_eulertigs.k_31.d_na.M_runsapprox.C_xz
spneumo_pangenome_k32	0.001	eulertigs	31	na	default	bzip	9627	298107	9627	288480	9616	9616	298107	83812	79604	71	79675	85684	spneumo_pangenome_k32.r_0.001.S_eulertigs.k_31.d_na.M_default.C_bzip
spneumo_pangenome_k32	0.001	eulertigs	31	na	default	xz	9627	298107	9627	288480	9616	9616	298107	83812	79604	236	79840	85684	spneumo_pangenome_k32.r_0.001.S_eulertigs.k_31.d_na.M_default.C_xz
spneumo_pangenome_k32	0.001	eulertigs	31	na	ones	bzip	9627	298107	9628	288479	9617	9616	298107	83812	79604	75	79679	85688	spneumo_pangenome_k32.r_0.001.S_eulertigs.k_31.d_na.M_ones.C_bzip
spneumo_pangenome_k32	0.001	eulertigs	31	na	ones	xz	9627	298107	9628	288479	9617	9616	298107	83812	79604	244	79848	85688	spneumo_pangenome_k32.r_0.001.S_eulertigs.k_31.d_na.M_ones.C_xz
spneumo_pangenome_k32	0.001	eulertigs	31	na	runsapprox	bzip	9627	298107	9628	288479	9617	9616	298107	83812	79604	75	79679	85688	spneumo_pangenome_k32.r_0.001.S_eulertigs.k_31.d_na.M_runsapprox.C_bzip
spneumo_pangenome_k32	0.001	eulertigs	31	na	runsapprox	xz	9627	298107	9628	288479	9617	9616	298107	83812	79604	244	79848	85688	spneumo_pangenome_k32.r_0.001.S_eulertigs.k_31.d_na.M_runsapprox.C_xz
spneumo_pangenome_k32	0.01	eulertigs	31	na	default	bzip	96277	2954527	96277	2858250	95275	95275	2954527	812852	742576	1781	744357	824968	spneumo_pangenome_k32.r_0.01.S_eulertigs.k_31.d_na.M_default.C_bzip
spneumo_pangenome_k32	0.01	eulertigs	31	na	default	xz	96277	2954527	96277	2858250	95275	95275	2954527	812852	742576	3520	746096	824968	spneumo_pangenome_k32.r_0.01.S_eulertigs.k_31.d_na.M_default.C_xz
spneumo_pangenome_k32	0.01	eulertigs	31	na	ones	bzip	96277	2954527	96506	2858021	95504	95275	2954527	812852	742576	2245	744821	824932	spneumo_pangenome_k32.r_0.01.S_eulertigs.k_31.d_na.M_ones.C_bzip
spneumo_pangenome_k32	0.01	eulertigs	31	na	ones	xz	96277	2954527	96506	2858021	95504	95275	2954527	812852	742576	4704	747280	824932	spneumo_pangenome_k32.r_0.01.S_eulertigs.k_31.d_na.M_ones.C_xz
spneumo_pangenome_k32	0.01	eulertigs	31	na	runsapprox	bzip	96277	2954527	96506	2858021	95504	95275	2954527	812852	742576	2245	744821	824932	spneumo_pangenome_k32.r_0.01.S_eulertigs.k_31.d_na.M_runsapprox.C_bzip
spneumo_pangenome_k32	0.01	eulertigs	31	na	runsapprox	xz	96277	2954527	96506	2858021	95504	95275	2954527	812852	742576	4704	747280	824932	spneumo_pangenome_k32.r_0.01.S_eulertigs.k_31.d_na.M_runsapprox.C_xz
spneumo_pangenome_k32	0.05	eulertigs	31	na	default	bzip	481387	14184937	481387	13703550	456785	456785	14184937	3563072	3230760	29158	3259918	3641564	spneumo_pangenome_k32.r_0.05.S_eulertigs.k_31.d_na.M_default.C_bzip
spneumo_pangenome_k32	0.05	eulertigs	31	na	default	xz	481387	14184937	481387	13703550	456785	456785	14184937	3563072	3230760	53184	3283944	3641564	spneumo_pangenome_k32.r_0.05.S_eulertigs.k_31.d_na.M_default.C_xz
spneumo_pangenome_k32	0.05	eulertigs	31	na	ones	bzip	481387	14184937	486049	13698888	461353	456785	14184937	3563072	3230760	36792	3267552	3645856	spneumo_pangenome_k32.r_0.05.S_eulertigs.k_31.d_na.M_ones.C_bzip
spneumo_pangenome_k32	0.05	eulertigs	31	na	ones	xz	481387	14184937	486049	13698888	461353	456785	14184937	3563072	3230760	71296	3302056	3645856	spneumo_pangenome_k32.r_0.05.S_eulertigs.k_31.d_na.M_ones.C_xz
spneumo_pangenome_k32	0.05	eulertigs	31	na	runsapprox	bzip	481387	14184937	486049	13698888	461353	456785	14184937	3563072	3230760	36792	3267552	3645856	spneumo_pangenome_k32.r_0.05.S_eulertigs.k_31.d_na.M_runsapprox.C_bzip
spneumo_pangenome_k32	0.05	eulertigs	31	na	runsapprox	xz	481387	14184937	486049	13698888	461353	456785	14184937	3563072	3230760	71296	3302056	3645856	spneumo_pangenome_k32.r_0.05.S_eulertigs.k_31.d_na.M_runsapprox.C_xz
spneumo_pangenome_k32	0.1	eulertigs	31	na	default	bzip	962775	26912655	962775	25949880	864996	864996	26912655	6311024	5728700	87989	5816689	6505668	spneumo_pangenome_k32.r_0.1.S_eulertigs.k_31.d_na.M_default.C_bzip
spneumo_pangenome_k32	0.1	eulertigs	31	na	default	xz	962775	26912655	962775	25949880	864996	864996	26912655	6311024	5728700	163252	5891952	6505668	spneumo_pangenome_k32.r_0.1.S_eulertigs.k_31.d_na.M_default.C_xz
spneumo_pangenome_k32	0.1	eulertigs	31	na	ones	bzip	962775	26912655	980395	25932260	882071	864996	26912655	6311024	5728700	113479	5842179	6519896	spneumo_pangenome_k32.r_0.1.S_eulertigs.k_31.d_na.M_ones.C_bzip
spneumo_pangenome_k32	0.1	eulertigs	31	na	ones	xz	962775	26912655	980395	25932260	882071	864996	26912655	6311024	5728700	220384	5949084	6519896	spneumo_pangenome_k32.r_0.1.S_eulertigs.k_31.d_na.M_ones.C_xz
spneumo_pangenome_k32	0.1	eulertigs	31	na	runsapprox	bzip	962775	26912655	980395	25932260	882071	864996	26912655	6311024	5728700	113479	5842179	6519896	spneumo_pangenome_k32.r_0.1.S_eulertigs.k_31.d_na.M_runsapprox.C_bzip
spneumo_pangenome_k32	0.1	eulertigs	31	na	runsapprox	xz	962775	26912655	980395	25932260	882071	864996	26912655	6311024	5728700	220384	5949084	6519896	spneumo_pangenome_k32.r_0.1.S_eulertigs.k_31.d_na.M_runsapprox.C_xz
spneumo_pangenome_k32	0.2	eulertigs	31	na	default	bzip	1925551	48017491	1925551	46091940	1536398	1536398	48017491	10488384	9534256	246876	9781132	10967240	spneumo_pangenome_k32.r_0.2.S_eulertigs.k_31.d_na.M_default.C_bzip
spneumo_pangenome_k32	0.2	eulertigs	31	na	default	xz	1925551	48017491	1925551	46091940	1536398	1536398	48017491	10488384	9534256	456072	9990328	10967240	spneumo_pangenome_k32.r_0.2.S_eulertigs.k_31.d_na.M_default.C_xz
spneumo_pangenome_k32	0.2	eulertigs	31	na	ones	bzip	1925551	48017491	1988371	46029120	1594947	1536398	48017491	10488384	9534256	326511	9860767	11022216	spneumo_pangenome_k32.r_0.2.S_eulertigs.k_31.d_na.M_ones.C_bzip
spneumo_pangenome_k32	0.2	eulertigs	31	na	ones	xz	1925551	48017491	1988371	46029120	1594947	1536398	48017491	10488384	9534256	614168	10148424	11022216	spneumo_pangenome_k32.r_0.2.S_eulertigs.k_31.d_na.M_ones.C_xz
spneumo_pangenome_k32	0.2	eulertigs	31	na	runsapprox	bzip	1925551	48017491	1988371	46029120	1594947	1536398	48017491	10488384	9534256	326511	9860767	11022216	spneumo_pangenome_k32.r_0.2.S_eulertigs.k_31.d_na.M_runsapprox.C_bzip
spneumo_pangenome_k32	0.2	eulertigs	31	na	runsapprox	xz	1925551	48017491	1988371	46029120	1594947	1536398	48017491	10488384	9534256	614168	10148424	11022216	spneumo_pangenome_k32.r_0.2.S_eulertigs.k_31.d_na.M_runsapprox.C_xz
spneumo_pangenome_k32	0.3	eulertigs	31	na	default	bzip	2888326	63375646	2888326	60487320	2016244	2016244	63375646	13322164	12115836	434374	12550210	14125328	spneumo_pangenome_k32.r_0.3.S_eulertigs.k_31.d_na.M_default.C_bzip
spneumo_pangenome_k32	0.3	eulertigs	31	na	default	xz	2888326	63375646	2888326	60487320	2016244	2016244	63375646	13322164	12115836	791804	12907640	14125328	spneumo_pangenome_k32.r_0.3.S_eulertigs.k_31.d_na.M_default.C_xz
spneumo_pangenome_k32	0.3	eulertigs	31	na	ones	bzip	2888326	63375646	3013351	60362295	2128416	2016244	63375646	13322164	12115836	581624	12697460	14239280	spneumo_pangenome_k32.r_0.3.S_eulertigs.k_31.d_na.M_ones.C_bzip
spneumo_pangenome_k32	0.3	eulertigs	31	na	ones	xz	2888326	63375646	3013351	60362295	2128416	2016244	63375646	13322164	12115836	1052144	13167980	14239280	spneumo_pangenome_k32.r_0.3.S_eulertigs.k_31.d_na.M_ones.C_xz
spneumo_pangenome_k32	0.3	eulertigs	31	na	runsapprox	bzip	2888326	63375646	3013351	60362295	2128416	2016244	63375646	13322164	12115836	581624	12697460	14239280	spneumo_pangenome_k32.r_0.3.S_eulertigs.k_31.d_na.M_runsapprox.C_bzip
spneumo_pangenome_k32	0.3	eulertigs	31	na	runsapprox	xz	2888326	63375646	3013351	60362295	2128416	2016244	63375646	13322164	12115836	1052144	13167980	14239280	spneumo_pangenome_k32.r_0.3.S_eulertigs.k_31.d_na.M_runsapprox.C_xz
spneumo_pangenome_k32	0.4	eulertigs	31	na	default	bzip	3851102	73032032	3851102	69180930	2306031	2306031	73032032	15039300	13646172	624853	14271025	16168224	spneumo_pangenome_k32.r_0.4.S_eulertigs.k_31.d_na.M_default.C_bzip
spneumo_pangenome_k32	0.4	eulertigs	31	na	default	xz	3851102	73032032	3851102	69180930	2306031	2306031	73032032	15039300	13646172	1123900	14770072	16168224	spneumo_pangenome_k32.r_0.4.S_eulertigs.k_31.d_na.M_default.C_xz
spneumo_pangenome_k32	0.4	eulertigs	31	na	ones	bzip	3851102	73032032	4042109	68989923	2469974	2306031	73032032	15039300	13646172	838688	14484860	16336040	spneumo_pangenome_k32.r_0.4.S_eulertigs.k_31.d_na.M_ones.C_bzip
spneumo_pangenome_k32	0.4	eulertigs	31	na	ones	xz	3851102	73032032	4042109	68989923	2469974	2306031	73032032	15039300	13646172	1460816	15106988	16336040	spneumo_pangenome_k32.r_0.4.S_eulertigs.k_31.d_na.M_ones.C_xz
spneumo_pangenome_k32	0.4	eulertigs	31	na	runsapprox	bzip	3851102	73032032	4042109	68989923	2469974	2306031	73032032	15039300	13646172	838688	14484860	16336040	spneumo_pangenome_k32.r_0.4.S_eulertigs.k_31.d_na.M_runsapprox.C_bzip
spneumo_pangenome_k32	0.4	eulertigs	31	na	runsapprox	xz	3851102	73032032	4042109	68989923	2469974	2306031	73032032	15039300	13646172	1460816	15106988	16336040	spneumo_pangenome_k32.r_0.4.S_eulertigs.k_31.d_na.M_runsapprox.C_xz
spneumo_pangenome_k32	0.5	eulertigs	31	na	default	bzip	4813877	77017937	4813877	72204060	2406802	2406802	77017937	15725608	14255096	794922	15050018	17160040	spneumo_pangenome_k32.r_0.5.S_eulertigs.k_31.d_na.M_default.C_bzip
spneumo_pangenome_k32	0.5	eulertigs	31	na	default	xz	4813877	77017937	4813877	72204060	2406802	2406802	77017937	15725608	14255096	1411924	15667020	17160040	spneumo_pangenome_k32.r_0.5.S_eulertigs.k_31.d_na.M_default.C_xz
spneumo_pangenome_k32	0.5	eulertigs	31	na	ones	bzip	4813877	77017937	5067523	71950414	2614126	2406802	77017937	15725608	14255096	1068471	15323567	17391016	spneumo_pangenome_k32.r_0.5.S_eulertigs.k_31.d_na.M_ones.C_bzip
spneumo_pangenome_k32	0.5	eulertigs	31	na	ones	xz	4813877	77017937	5067523	71950414	2614126	2406802	77017937	15725608	14255096	1791560	16046656	17391016	spneumo_pangenome_k32.r_0.5.S_eulertigs.k_31.d_na.M_ones.C_xz
spneumo_pangenome_k32	0.5	eulertigs	31	na	runsapprox	bzip	4813877	77017937	5067523	71950414	2614126	2406802	77017937	15725608	14255096	1068471	15323567	17391016	spneumo_pangenome_k32.r_0.5.S_eulertigs.k_31.d_na.M_runsapprox.C_bzip
spneumo_pangenome_k32	0.5	eulertigs	31	na	runsapprox	xz	4813877	77017937	5067523	71950414	2614126	2406802	77017937	15725608	14255096	1791560	16046656	17391016	spneumo_pangenome_k32.r_0.5.S_eulertigs.k_31.d_na.M_runsapprox.C_xz
spneumo_pangenome_k32	0.6	eulertigs	31	na	default	bzip	5776653	75441153	5776653	69664500	2322150	2322150	75441153	15374632	13950648	918142	14868790	17088700	spneumo_pangenome_k32.r_0.6.S_eulertigs.k_31.d_na.M_default.C_bzip
spneumo_pangenome_k32	0.6	eulertigs	31	na	default	xz	5776653	75441153	5776653	69664500	2322150	2322150	75441153	15374632	13950648	1604744	15555392	17088700	spneumo_pangenome_k32.r_0.6.S_eulertigs.k_31.d_na.M_default.C_xz
spneumo_pangenome_k32	0.6	eulertigs	31	na	ones	bzip	5776653	75441153	6075665	69365488	2552521	2322150	75441153	15374632	13950648	1228232	15178880	17350892	spneumo_pangenome_k32.r_0.6.S_eulertigs.k_31.d_na.M_ones.C_bzip
spneumo_pangenome_k32	0.6	eulertigs	31	na	ones	xz	5776653	75441153	6075665	69365488	2552521	2322150	75441153	15374632	13950648	1986564	15937212	17350892	spneumo_pangenome_k32.r_0.6.S_eulertigs.k_31.d_na.M_ones.C_xz
spneumo_pangenome_k32	0.6	eulertigs	31	na	runsapprox	bzip	5776653	75441153	6075665	69365488	2552521	2322150	75441153	15374632	13950648	1228232	15178880	17350892	spneumo_pangenome_k32.r_0.6.S_eulertigs.k_31.d_na.M_runsapprox.C_bzip
spneumo_pangenome_k32	0.6	eulertigs	31	na	runsapprox	xz	5776653	75441153	6075665	69365488	2552521	2322150	75441153	15374632	13950648	1986564	15937212	17350892	spneumo_pangenome_k32.r_0.6.S_eulertigs.k_31.d_na.M_runsapprox.C_xz
spneumo_pangenome_k32	0.7	eulertigs	31	na	default	bzip	6739428	68362728	6739428	61623300	2054110	2054110	68362728	13994176	12714860	955842	13670702	15929372	spneumo_pangenome_k32.r_0.7.S_eulertigs.k_31.d_na.M_default.C_bzip
spneumo_pangenome_k32	0.7	eulertigs	31	na	default	xz	6739428	68362728	6739428	61623300	2054110	2054110	68362728	13994176	12714860	1648704	14363564	15929372	spneumo_pangenome_k32.r_0.7.S_eulertigs.k_31.d_na.M_default.C_xz
spneumo_pangenome_k32	0.7	eulertigs	31	na	ones	bzip	6739428	68362728	7056847	61305881	2280583	2054110	68362728	13994176	12714860	1274458	13989318	16201792	spneumo_pangenome_k32.r_0.7.S_eulertigs.k_31.d_na.M_ones.C_bzip
spneumo_pangenome_k32	0.7	eulertigs	31	na	ones	xz	6739428	68362728	7056847	61305881	2280583	2054110	68362728	13994176	12714860	1998120	14712980	16201792	spneumo_pangenome_k32.r_0.7.S_eulertigs.k_31.d_na.M_ones.C_xz
spneumo_pangenome_k32	0.7	eulertigs	31	na	runsapprox	bzip	6739428	68362728	7056847	61305881	2280583	2054110	68362728	13994176	12714860	1274458	13989318	16201792	spneumo_pangenome_k32.r_0.7.S_eulertigs.k_31.d_na.M_runsapprox.C_bzip
spneumo_pangenome_k32	0.7	eulertigs	31	na	runsapprox	xz	6739428	68362728	7056847	61305881	2280583	2054110	68362728	13994176	12714860	1998120	14712980	16201792	spneumo_pangenome_k32.r_0.7.S_eulertigs.k_31.d_na.M_runsapprox.C_xz
spneumo_pangenome_k32	0.8	eulertigs	31	na	default	bzip	7702204	55782304	7702204	48080100	1602670	1602670	55782304	11551612	10532508	876719	11409227	13575984	spneumo_pangenome_k32.r_0.8.S_eulertigs.k_31.d_na.M_default.C_bzip
spneumo_pangenome_k32	0.8	eulertigs	31	na	default	xz	7702204	55782304	7702204	48080100	1602670	1602670	55782304	11551612	10532508	1487116	12019624	13575984	spneumo_pangenome_k32.r_0.8.S_eulertigs.k_31.d_na.M_default.C_xz
spneumo_pangenome_k32	0.8	eulertigs	31	na	ones	bzip	7702204	55782304	8002453	47779851	1792647	1602670	55782304	11551612	10532508	1162132	11694640	13829452	spneumo_pangenome_k32.r_0.8.S_eulertigs.k_31.d_na.M_ones.C_bzip
spneumo_pangenome_k32	0.8	eulertigs	31	na	ones	xz	7702204	55782304	8002453	47779851	1792647	1602670	55782304	11551612	10532508	1774372	12306880	13829452	spneumo_pangenome_k32.r_0.8.S_eulertigs.k_31.d_na.M_ones.C_xz
spneumo_pangenome_k32	0.8	eulertigs	31	na	runsapprox	bzip	7702204	55782304	8002453	47779851	1792647	1602670	55782304	11551612	10532508	1162132	11694640	13829452	spneumo_pangenome_k32.r_0.8.S_eulertigs.k_31.d_na.M_runsapprox.C_bzip
spneumo_pangenome_k32	0.8	eulertigs	31	na	runsapprox	xz	7702204	55782304	8002453	47779851	1792647	1602670	55782304	11551612	10532508	1774372	12306880	13829452	spneumo_pangenome_k32.r_0.8.S_eulertigs.k_31.d_na.M_runsapprox.C_xz
spneumo_pangenome_k32	0.9	eulertigs	31	na	default	bzip	8664979	37755259	8664979	29090280	969676	969676	37755259	7929732	7269828	636937	7906765	9751268	spneumo_pangenome_k32.r_0.9.S_eulertigs.k_31.d_na.M_default.C_bzip
spneumo_pangenome_k32	0.9	eulertigs	31	na	default	xz	8664979	37755259	8664979	29090280	969676	969676	37755259	7929732	7269828	1052680	8322508	9751268	spneumo_pangenome_k32.r_0.9.S_eulertigs.k_31.d_na.M_default.C_xz
spneumo_pangenome_k32	0.9	eulertigs	31	na	ones	bzip	8664979	37755259	8902157	28853102	1085694	969676	37755259	7929732	7269828	843084	8112912	9931264	spneumo_pangenome_k32.r_0.9.S_eulertigs.k_31.d_na.M_ones.C_bzip
spneumo_pangenome_k32	0.9	eulertigs	31	na	ones	xz	8664979	37755259	8902157	28853102	1085694	969676	37755259	7929732	7269828	1253032	8522860	9931264	spneumo_pangenome_k32.r_0.9.S_eulertigs.k_31.d_na.M_ones.C_xz
spneumo_pangenome_k32	0.9	eulertigs	31	na	runsapprox	bzip	8664979	37755259	8902157	28853102	1085694	969676	37755259	7929732	7269828	843084	8112912	9931264	spneumo_pangenome_k32.r_0.9.S_eulertigs.k_31.d_na.M_runsapprox.C_bzip
spneumo_pangenome_k32	0.9	eulertigs	31	na	runsapprox	xz	8664979	37755259	8902157	28853102	1085694	969676	37755259	7929732	7269828	1253032	8522860	9931264	spneumo_pangenome_k32.r_0.9.S_eulertigs.k_31.d_na.M_runsapprox.C_xz
spneumo_pangenome_k32	1.0	eulertigs	31	na	default	bzip	9627755	14382545	9627755	4754790	158493	158493	14382545	2869264	2727976	135281	2863257	3473796	spneumo_pangenome_k32.r_1.0.S_eulertigs.k_31.d_na.M_default.C_bzip
spneumo_pangenome_k32	1.0	eulertigs	31	na	default	xz	9627755	14382545	9627755	4754790	158493	158493	14382545	2869264	2727976	249340	2977316	3473796	spneumo_pangenome_k32.r_1.0.S_eulertigs.k_31.d_na.M_default.C_xz
spneumo_pangenome_k32	1.0	eulertigs	31	na	ones	bzip	9627755	14382545	9744242	4638303	158653	158493	14382545	2869264	2727976	180912	2908888	3483808	spneumo_pangenome_k32.r_1.0.S_eulertigs.k_31.d_na.M_ones.C_bzip
spneumo_pangenome_k32	1.0	eulertigs	31	na	ones	xz	9627755	14382545	9744242	4638303	158653	158493	14382545	2869264	2727976	304792	3032768	3483808	spneumo_pangenome_k32.r_1.0.S_eulertigs.k_31.d_na.M_ones.C_xz
spneumo_pangenome_k32	1.0	eulertigs	31	na	runsapprox	bzip	9627755	14382545	9744242	4638303	158653	158493	14382545	2869264	2727976	180912	2908888	3483808	spneumo_pangenome_k32.r_1.0.S_eulertigs.k_31.d_na.M_runsapprox.C_bzip
spneumo_pangenome_k32	1.0	eulertigs	31	na	runsapprox	xz	9627755	14382545	9744242	4638303	158653	158493	14382545	2869264	2727976	304792	3032768	3483808	spneumo_pangenome_k32.r_1.0.S_eulertigs.k_31.d_na.M_runsapprox.C_xz
spneumo_pangenome_k32	0.000000001	greedytigs	31	na	default	bzip	1	31	1	30	1	1	31	96	96	41	137	96	spneumo_pangenome_k32.r_0.000000001.S_greedytigs.k_31.d_na.M_default.C_bzip
spneumo_pangenome_k32	0.000000001	greedytigs	31	na	default	xz	1	31	1	30	1	1	31	96	96	76	172	96	spneumo_pangenome_k32.r_0.000000001.S_greedytigs.k_31.d_na.M_default.C_xz
spneumo_pangenome_k32	0.000000001	greedytigs	31	na	ones	bzip	1	31	1	30	1	1	31	96	96	41	137	96	spneumo_pangenome_k32.r_0.000000001.S_greedytigs.k_31.d_na.M_ones.C_bzip
spneumo_pangenome_k32	0.000000001	greedytigs	31	na	ones	xz	1	31	1	30	1	1	31	96	96	76	172	96	spneumo_pangenome_k32.r_0.000000001.S_greedytigs.k_31.d_na.M_ones.C_xz
spneumo_pangenome_k32	0.000000001	greedytigs	31	na	runsapprox	bzip	1	31	1	30	1	1	31	96	96	41	137	96	spneumo_pangenome_k32.r_0.000000001.S_greedytigs.k_31.d_na.M_runsapprox.C_bzip
spneumo_pangenome_k32	0.000000001	greedytigs	31	na	runsapprox	xz	1	31	1	30	1	1	31	96	96	76	172	96	spneumo_pangenome_k32.r_0.000000001.S_greedytigs.k_31.d_na.M_runsapprox.C_xz
spneumo_pangenome_k32	0.0001	greedytigs	31	na	default	bzip	962	29822	962	28860	962	962	29822	8684	8348	47	8395	8732	spneumo_pangenome_k32.r_0.0001.S_greedytigs.k_31.d_na.M_default.C_bzip
spneumo_pangenome_k32	0.0001	greedytigs	31	na	default	xz	962	29822	962	28860	962	962	29822	8684	8348	144	8492	8732	spneumo_pangenome_k32.r_0.0001.S_greedytigs.k_31.d_na.M_default.C_xz
spneumo_pangenome_k32	0.0001	greedytigs	31	na	ones	bzip	962	29822	962	28860	962	962	29822	8684	8348	47	8395	8732	spneumo_pangenome_k32.r_0.0001.S_greedytigs.k_31.d_na.M_ones.C_bzip
spneumo_pangenome_k32	0.0001	greedytigs	31	na	ones	xz	962	29822	962	28860	962	962	29822	8684	8348	144	8492	8732	spneumo_pangenome_k32.r_0.0001.S_greedytigs.k_31.d_na.M_ones.C_xz
spneumo_pangenome_k32	0.0001	greedytigs	31	na	runsapprox	bzip	962	29822	962	28860	962	962	29822	8684	8348	47	8395	8732	spneumo_pangenome_k32.r_0.0001.S_greedytigs.k_31.d_na.M_runsapprox.C_bzip
spneumo_pangenome_k32	0.0001	greedytigs	31	na	runsapprox	xz	962	29822	962	28860	962	962	29822	8684	8348	144	8492	8732	spneumo_pangenome_k32.r_0.0001.S_greedytigs.k_31.d_na.M_runsapprox.C_xz
spneumo_pangenome_k32	0.001	greedytigs	31	na	default	bzip	9627	298107	9627	288480	9616	9616	298107	83812	79604	71	79675	85684	spneumo_pangenome_k32.r_0.001.S_greedytigs.k_31.d_na.M_default.C_bzip
spneumo_pangenome_k32	0.001	greedytigs	31	na	default	xz	9627	298107	9627	288480	9616	9616	298107	83812	79604	236	79840	85684	spneumo_pangenome_k32.r_0.001.S_greedytigs.k_31.d_na.M_default.C_xz
spneumo_pangenome_k32	0.001	greedytigs	31	na	ones	bzip	9627	298107	9628	288479	9617	9616	298107	83812	79604	75	79679	85688	spneumo_pangenome_k32.r_0.001.S_greedytigs.k_31.d_na.M_ones.C_bzip
spneumo_pangenome_k32	0.001	greedytigs	31	na	ones	xz	9627	298107	9628	288479	9617	9616	298107	83812	79604	244	79848	85688	spneumo_pangenome_k32.r_0.001.S_greedytigs.k_31.d_na.M_ones.C_xz
spneumo_pangenome_k32	0.001	greedytigs	31	na	runsapprox	bzip	9627	298107	9628	288479	9617	9616	298107	83812	79604	75	79679	85688	spneumo_pangenome_k32.r_0.001.S_greedytigs.k_31.d_na.M_runsapprox.C_bzip
spneumo_pangenome_k32	0.001	greedytigs	31	na	runsapprox	xz	9627	298107	9628	288479	9617	9616	298107	83812	79604	244	79848	85688	spneumo_pangenome_k32.r_0.001.S_greedytigs.k_31.d_na.M_runsapprox.C_xz
spneumo_pangenome_k32	0.01	greedytigs	31	na	default	bzip	96277	2954527	96277	2858250	95275	95275	2954527	812852	742576	1781	744357	824968	spneumo_pangenome_k32.r_0.01.S_greedytigs.k_31.d_na.M_default.C_bzip
spneumo_pangenome_k32	0.01	greedytigs	31	na	default	xz	96277	2954527	96277	2858250	95275	95275	2954527	812852	742576	3520	746096	824968	spneumo_pangenome_k32.r_0.01.S_greedytigs.k_31.d_na.M_default.C_xz
spneumo_pangenome_k32	0.01	greedytigs	31	na	ones	bzip	96277	2954527	96506	2858021	95504	95275	2954527	812852	742576	2245	744821	824932	spneumo_pangenome_k32.r_0.01.S_greedytigs.k_31.d_na.M_ones.C_bzip
spneumo_pangenome_k32	0.01	greedytigs	31	na	ones	xz	96277	2954527	96506	2858021	95504	95275	2954527	812852	742576	4704	747280	824932	spneumo_pangenome_k32.r_0.01.S_greedytigs.k_31.d_na.M_ones.C_xz
spneumo_pangenome_k32	0.01	greedytigs	31	na	runsapprox	bzip	96277	2954527	96506	2858021	95504	95275	2954527	812852	742576	2245	744821	824932	spneumo_pangenome_k32.r_0.01.S_greedytigs.k_31.d_na.M_runsapprox.C_bzip
spneumo_pangenome_k32	0.01	greedytigs	31	na	runsapprox	xz	96277	2954527	96506	2858021	95504	95275	2954527	812852	742576	4704	747280	824932	spneumo_pangenome_k32.r_0.01.S_greedytigs.k_31.d_na.M_runsapprox.C_xz
spneumo_pangenome_k32	0.05	greedytigs	31	na	default	bzip	481387	14184937	481387	13703550	456785	456785	14184937	3563072	3230760	29158	3259918	3641564	spneumo_pangenome_k32.r_0.05.S_greedytigs.k_31.d_na.M_default.C_bzip
spneumo_pangenome_k32	0.05	greedytigs	31	na	default	xz	481387	14184937	481387	13703550	456785	456785	14184937	3563072	3230760	53184	3283944	3641564	spneumo_pangenome_k32.r_0.05.S_greedytigs.k_31.d_na.M_default.C_xz
spneumo_pangenome_k32	0.05	greedytigs	31	na	ones	bzip	481387	14184937	486049	13698888	461353	456785	14184937	3563072	3230760	36792	3267552	3645856	spneumo_pangenome_k32.r_0.05.S_greedytigs.k_31.d_na.M_ones.C_bzip
spneumo_pangenome_k32	0.05	greedytigs	31	na	ones	xz	481387	14184937	486049	13698888	461353	456785	14184937	3563072	3230760	71296	3302056	3645856	spneumo_pangenome_k32.r_0.05.S_greedytigs.k_31.d_na.M_ones.C_xz
spneumo_pangenome_k32	0.05	greedytigs	31	na	runsapprox	bzip	481387	14184937	486049	13698888	461353	456785	14184937	3563072	3230760	36792	3267552	3645856	spneumo_pangenome_k32.r_0.05.S_greedytigs.k_31.d_na.M_runsapprox.C_bzip
spneumo_pangenome_k32	0.05	greedytigs	31	na	runsapprox	xz	481387	14184937	486049	13698888	461353	456785	14184937	3563072	3230760	71296	3302056	3645856	spneumo_pangenome_k32.r_0.05.S_greedytigs.k_31.d_na.M_runsapprox.C_xz
spneumo_pangenome_k32	0.1	greedytigs	31	na	default	bzip	962775	26912655	962775	25949880	864996	864996	26912655	6311024	5728700	87989	5816689	6505668	spneumo_pangenome_k32.r_0.1.S_greedytigs.k_31.d_na.M_default.C_bzip
spneumo_pangenome_k32	0.1	greedytigs	31	na	default	xz	962775	26912655	962775	25949880	864996	864996	26912655	6311024	5728700	163252	5891952	6505668	spneumo_pangenome_k32.r_0.1.S_greedytigs.k_31.d_na.M_default.C_xz
spneumo_pangenome_k32	0.1	greedytigs	31	na	ones	bzip	962775	26912655	980395	25932260	882071	864996	26912655	6311024	5728700	113479	5842179	6519896	spneumo_pangenome_k32.r_0.1.S_greedytigs.k_31.d_na.M_ones.C_bzip
spneumo_pangenome_k32	0.1	greedytigs	31	na	ones	xz	962775	26912655	980395	25932260	882071	864996	26912655	6311024	5728700	220384	5949084	6519896	spneumo_pangenome_k32.r_0.1.S_greedytigs.k_31.d_na.M_ones.C_xz
spneumo_pangenome_k32	0.1	greedytigs	31	na	runsapprox	bzip	962775	26912655	980395	25932260	882071	864996	26912655	6311024	5728700	113479	5842179	6519896	spneumo_pangenome_k32.r_0.1.S_greedytigs.k_31.d_na.M_runsapprox.C_bzip
spneumo_pangenome_k32	0.1	greedytigs	31	na	runsapprox	xz	962775	26912655	980395	25932260	882071	864996	26912655	6311024	5728700	220384	5949084	6519896	spneumo_pangenome_k32.r_0.1.S_greedytigs.k_31.d_na.M_runsapprox.C_xz
spneumo_pangenome_k32	0.2	greedytigs	31	na	default	bzip	1925551	48017350	1925560	46091790	1536393	1536393	48017350	10480592	9528692	246892	9775584	10961372	spneumo_pangenome_k32.r_0.2.S_greedytigs.k_31.d_na.M_default.C_bzip
spneumo_pangenome_k32	0.2	greedytigs	31	na	default	xz	1925551	48017350	1925560	46091790	1536393	1536393	48017350	10480592	9528692	456208	9984900	10961372	spneumo_pangenome_k32.r_0.2.S_greedytigs.k_31.d_na.M_default.C_xz
spneumo_pangenome_k32	0.2	greedytigs	31	na	ones	bzip	1925551	48017350	1988036	46029314	1594595	1536393	48017350	10480592	9528692	325727	9854419	11015564	spneumo_pangenome_k32.r_0.2.S_greedytigs.k_31.d_na.M_ones.C_bzip
spneumo_pangenome_k32	0.2	greedytigs	31	na	ones	xz	1925551	48017350	1988036	46029314	1594595	1536393	48017350	10480592	9528692	613908	10142600	11015564	spneumo_pangenome_k32.r_0.2.S_greedytigs.k_31.d_na.M_ones.C_xz
spneumo_pangenome_k32	0.2	greedytigs	31	na	runsapprox	bzip	1925551	48017350	1988036	46029314	1594595	1536393	48017350	10480592	9528692	325727	9854419	11015564	spneumo_pangenome_k32.r_0.2.S_greedytigs.k_31.d_na.M_runsapprox.C_bzip
spneumo_pangenome_k32	0.2	greedytigs	31	na	runsapprox	xz	1925551	48017350	1988036	46029314	1594595	1536393	48017350	10480592	9528692	613908	10142600	11015564	spneumo_pangenome_k32.r_0.2.S_greedytigs.k_31.d_na.M_runsapprox.C_xz
spneumo_pangenome_k32	0.3	greedytigs	31	na	default	bzip	2888326	63374477	2888387	60486090	2016203	2016203	63374477	13320640	12093788	434252	12528040	14134668	spneumo_pangenome_k32.r_0.3.S_greedytigs.k_31.d_na.M_default.C_bzip
spneumo_pangenome_k32	0.3	greedytigs	31	na	default	xz	2888326	63374477	2888387	60486090	2016203	2016203	63374477	13320640	12093788	791444	12885232	14134668	spneumo_pangenome_k32.r_0.3.S_greedytigs.k_31.d_na.M_default.C_xz
spneumo_pangenome_k32	0.3	greedytigs	31	na	ones	bzip	2888326	63374477	3012632	60361845	2127616	2016203	63374477	13320640	12093788	580796	12674584	14243128	spneumo_pangenome_k32.r_0.3.S_greedytigs.k_31.d_na.M_ones.C_bzip
spneumo_pangenome_k32	0.3	greedytigs	31	na	ones	xz	2888326	63374477	3012632	60361845	2127616	2016203	63374477	13320640	12093788	1050800	13144588	14243128	spneumo_pangenome_k32.r_0.3.S_greedytigs.k_31.d_na.M_ones.C_xz
spneumo_pangenome_k32	0.3	greedytigs	31	na	runsapprox	bzip	2888326	63374477	3012632	60361845	2127616	2016203	63374477	13320640	12093788	580796	12674584	14243128	spneumo_pangenome_k32.r_0.3.S_greedytigs.k_31.d_na.M_runsapprox.C_bzip
spneumo_pangenome_k32	0.3	greedytigs	31	na	runsapprox	xz	2888326	63374477	3012632	60361845	2127616	2016203	63374477	13320640	12093788	1050800	13144588	14243128	spneumo_pangenome_k32.r_0.3.S_greedytigs.k_31.d_na.M_runsapprox.C_xz
spneumo_pangenome_k32	0.4	greedytigs	31	na	default	bzip	3851102	73026527	3851447	69175080	2305836	2305836	73026527	15035620	13647248	624908	14272156	16167232	spneumo_pangenome_k32.r_0.4.S_greedytigs.k_31.d_na.M_default.C_bzip
spneumo_pangenome_k32	0.4	greedytigs	31	na	default	xz	3851102	73026527	3851447	69175080	2305836	2305836	73026527	15035620	13647248	1124128	14771376	16167232	spneumo_pangenome_k32.r_0.4.S_greedytigs.k_31.d_na.M_default.C_xz
spneumo_pangenome_k32	0.4	greedytigs	31	na	ones	bzip	3851102	73026527	4041902	68984625	2469745	2305836	73026527	15035620	13647248	838467	14485715	16333640	spneumo_pangenome_k32.r_0.4.S_greedytigs.k_31.d_na.M_ones.C_bzip
spneumo_pangenome_k32	0.4	greedytigs	31	na	ones	xz	3851102	73026527	4041902	68984625	2469745	2305836	73026527	15035620	13647248	1460140	15107388	16333640	spneumo_pangenome_k32.r_0.4.S_greedytigs.k_31.d_na.M_ones.C_xz
spneumo_pangenome_k32	0.4	greedytigs	31	na	runsapprox	bzip	3851102	73026527	4041902	68984625	2469745	2305836	73026527	15035620	13647248	838467	14485715	16333640	spneumo_pangenome_k32.r_0.4.S_greedytigs.k_31.d_na.M_runsapprox.C_bzip
spneumo_pangenome_k32	0.4	greedytigs	31	na	runsapprox	xz	3851102	73026527	4041902	68984625	2469745	2305836	73026527	15035620	13647248	1460140	15107388	16333640	spneumo_pangenome_k32.r_0.4.S_greedytigs.k_31.d_na.M_runsapprox.C_xz
spneumo_pangenome_k32	0.5	greedytigs	31	na	default	bzip	4813877	76999895	4815185	72184710	2406157	2406157	76999895	15718476	14277068	795247	15072315	17160920	spneumo_pangenome_k32.r_0.5.S_greedytigs.k_31.d_na.M_default.C_bzip
spneumo_pangenome_k32	0.5	greedytigs	31	na	default	xz	4813877	76999895	4815185	72184710	2406157	2406157	76999895	15718476	14277068	1412400	15689468	17160920	spneumo_pangenome_k32.r_0.5.S_greedytigs.k_31.d_na.M_default.C_xz
spneumo_pangenome_k32	0.5	greedytigs	31	na	ones	bzip	4813877	76999895	5068154	71931741	2613286	2406157	76999895	15718476	14277068	1068601	15345669	17385396	spneumo_pangenome_k32.r_0.5.S_greedytigs.k_31.d_na.M_ones.C_bzip
spneumo_pangenome_k32	0.5	greedytigs	31	na	ones	xz	4813877	76999895	5068154	71931741	2613286	2406157	76999895	15718476	14277068	1790896	16067964	17385396	spneumo_pangenome_k32.r_0.5.S_greedytigs.k_31.d_na.M_ones.C_xz
spneumo_pangenome_k32	0.5	greedytigs	31	na	runsapprox	bzip	4813877	76999895	5068154	71931741	2613286	2406157	76999895	15718476	14277068	1068601	15345669	17385396	spneumo_pangenome_k32.r_0.5.S_greedytigs.k_31.d_na.M_runsapprox.C_bzip
spneumo_pangenome_k32	0.5	greedytigs	31	na	runsapprox	xz	4813877	76999895	5068154	71931741	2613286	2406157	76999895	15718476	14277068	1790896	16067964	17385396	spneumo_pangenome_k32.r_0.5.S_greedytigs.k_31.d_na.M_runsapprox.C_xz
spneumo_pangenome_k32	0.6	greedytigs	31	na	default	bzip	5776653	75392223	5781003	69611220	2320374	2320374	75392223	15367604	13956972	918845	14875817	17088996	spneumo_pangenome_k32.r_0.6.S_greedytigs.k_31.d_na.M_default.C_bzip
spneumo_pangenome_k32	0.6	greedytigs	31	na	default	xz	5776653	75392223	5781003	69611220	2320374	2320374	75392223	15367604	13956972	1604936	15561908	17088996	spneumo_pangenome_k32.r_0.6.S_greedytigs.k_31.d_na.M_default.C_xz
spneumo_pangenome_k32	0.6	greedytigs	31	na	ones	bzip	5776653	75392223	6079222	69313001	2551164	2320374	75392223	15367604	13956972	1228105	15185077	17346556	spneumo_pangenome_k32.r_0.6.S_greedytigs.k_31.d_na.M_ones.C_bzip
spneumo_pangenome_k32	0.6	greedytigs	31	na	ones	xz	5776653	75392223	6079222	69313001	2551164	2320374	75392223	15367604	13956972	1986176	15943148	17346556	spneumo_pangenome_k32.r_0.6.S_greedytigs.k_31.d_na.M_ones.C_xz
spneumo_pangenome_k32	0.6	greedytigs	31	na	runsapprox	bzip	5776653	75392223	6079222	69313001	2551164	2320374	75392223	15367604	13956972	1228105	15185077	17346556	spneumo_pangenome_k32.r_0.6.S_greedytigs.k_31.d_na.M_runsapprox.C_bzip
spneumo_pangenome_k32	0.6	greedytigs	31	na	runsapprox	xz	5776653	75392223	6079222	69313001	2551164	2320374	75392223	15367604	13956972	1986176	15943148	17346556	spneumo_pangenome_k32.r_0.6.S_greedytigs.k_31.d_na.M_runsapprox.C_xz
spneumo_pangenome_k32	0.7	greedytigs	31	na	default	bzip	6739428	68237899	6754039	61483860	2049462	2049462	68237899	13968240	12705884	956846	13662730	15911536	spneumo_pangenome_k32.r_0.7.S_greedytigs.k_31.d_na.M_default.C_bzip
spneumo_pangenome_k32	0.7	greedytigs	31	na	default	xz	6739428	68237899	6754039	61483860	2049462	2049462	68237899	13968240	12705884	1648392	14354276	15911536	spneumo_pangenome_k32.r_0.7.S_greedytigs.k_31.d_na.M_default.C_xz
spneumo_pangenome_k32	0.7	greedytigs	31	na	ones	bzip	6739428	68237899	7068258	61169641	2275891	2049462	68237899	13968240	12705884	1271478	13977362	16181628	spneumo_pangenome_k32.r_0.7.S_greedytigs.k_31.d_na.M_ones.C_bzip
spneumo_pangenome_k32	0.7	greedytigs	31	na	ones	xz	6739428	68237899	7068258	61169641	2275891	2049462	68237899	13968240	12705884	1995280	14701164	16181628	spneumo_pangenome_k32.r_0.7.S_greedytigs.k_31.d_na.M_ones.C_xz
spneumo_pangenome_k32	0.7	greedytigs	31	na	runsapprox	bzip	6739428	68237899	7068258	61169641	2275891	2049462	68237899	13968240	12705884	1271478	13977362	16181628	spneumo_pangenome_k32.r_0.7.S_greedytigs.k_31.d_na.M_runsapprox.C_bzip
spneumo_pangenome_k32	0.7	greedytigs	31	na	runsapprox	xz	6739428	68237899	7068258	61169641	2275891	2049462	68237899	13968240	12705884	1995280	14701164	16181628	spneumo_pangenome_k32.r_0.7.S_greedytigs.k_31.d_na.M_runsapprox.C_xz
spneumo_pangenome_k32	0.8	greedytigs	31	na	default	bzip	7702204	55489687	7751977	47737710	1591257	1591257	55489687	11496412	10480768	874749	11355517	13538184	spneumo_pangenome_k32.r_0.8.S_greedytigs.k_31.d_na.M_default.C_bzip
spneumo_pangenome_k32	0.8	greedytigs	31	na	default	xz	7702204	55489687	7751977	47737710	1591257	1591257	55489687	11496412	10480768	1483508	11964276	13538184	spneumo_pangenome_k32.r_0.8.S_greedytigs.k_31.d_na.M_default.C_xz
spneumo_pangenome_k32	0.8	greedytigs	31	na	ones	bzip	7702204	55489687	8042650	47447037	1780867	1591257	55489687	11496412	10480768	1153339	11634107	13788000	spneumo_pangenome_k32.r_0.8.S_greedytigs.k_31.d_na.M_ones.C_bzip
spneumo_pangenome_k32	0.8	greedytigs	31	na	ones	xz	7702204	55489687	8042650	47447037	1780867	1591257	55489687	11496412	10480768	1764764	12245532	13788000	spneumo_pangenome_k32.r_0.8.S_greedytigs.k_31.d_na.M_ones.C_xz
spneumo_pangenome_k32	0.8	greedytigs	31	na	runsapprox	bzip	7702204	55489687	8042650	47447037	1780867	1591257	55489687	11496412	10480768	1153339	11634107	13788000	spneumo_pangenome_k32.r_0.8.S_greedytigs.k_31.d_na.M_runsapprox.C_bzip
spneumo_pangenome_k32	0.8	greedytigs	31	na	runsapprox	xz	7702204	55489687	8042650	47447037	1780867	1591257	55489687	11496412	10480768	1764764	12245532	13788000	spneumo_pangenome_k32.r_0.8.S_greedytigs.k_31.d_na.M_runsapprox.C_xz
spneumo_pangenome_k32	0.9	greedytigs	31	na	default	bzip	8664979	37084584	8871564	28213020	940434	940434	37084584	7788000	7153328	627919	7781247	9625064	spneumo_pangenome_k32.r_0.9.S_greedytigs.k_31.d_na.M_default.C_bzip
spneumo_pangenome_k32	0.9	greedytigs	31	na	default	xz	8664979	37084584	8871564	28213020	940434	940434	37084584	7788000	7153328	1033504	8186832	9625064	spneumo_pangenome_k32.r_0.9.S_greedytigs.k_31.d_na.M_default.C_xz
spneumo_pangenome_k32	0.9	greedytigs	31	na	ones	bzip	8664979	37084584	9087093	27997491	1056867	940434	37084584	7788000	7153328	821462	7974790	9789676	spneumo_pangenome_k32.r_0.9.S_greedytigs.k_31.d_na.M_ones.C_bzip
spneumo_pangenome_k32	0.9	greedytigs	31	na	ones	xz	8664979	37084584	9087093	27997491	1056867	940434	37084584	7788000	7153328	1224696	8378024	9789676	spneumo_pangenome_k32.r_0.9.S_greedytigs.k_31.d_na.M_ones.C_xz
spneumo_pangenome_k32	0.9	greedytigs	31	na	runsapprox	bzip	8664979	37084584	9087093	27997491	1056867	940434	37084584	7788000	7153328	821462	7974790	9789676	spneumo_pangenome_k32.r_0.9.S_greedytigs.k_31.d_na.M_runsapprox.C_bzip
spneumo_pangenome_k32	0.9	greedytigs	31	na	runsapprox	xz	8664979	37084584	9087093	27997491	1056867	940434	37084584	7788000	7153328	1224696	8378024	9789676	spneumo_pangenome_k32.r_0.9.S_greedytigs.k_31.d_na.M_runsapprox.C_xz
spneumo_pangenome_k32	1.0	greedytigs	31	na	default	bzip	9627755	12822370	10874860	1947510	64917	64917	12822370	2312300	2245088	72665	2317753	2660436	spneumo_pangenome_k32.r_1.0.S_greedytigs.k_31.d_na.M_default.C_bzip
spneumo_pangenome_k32	1.0	greedytigs	31	na	default	xz	9627755	12822370	10874860	1947510	64917	64917	12822370	2312300	2245088	151728	2396816	2660436	spneumo_pangenome_k32.r_1.0.S_greedytigs.k_31.d_na.M_default.C_xz
spneumo_pangenome_k32	1.0	greedytigs	31	na	ones	bzip	9627755	12822370	10922013	1900357	64966	64917	12822370	2312300	2245088	89045	2334133	2661900	spneumo_pangenome_k32.r_1.0.S_greedytigs.k_31.d_na.M_ones.C_bzip
spneumo_pangenome_k32	1.0	greedytigs	31	na	ones	xz	9627755	12822370	10922013	1900357	64966	64917	12822370	2312300	2245088	172852	2417940	2661900	spneumo_pangenome_k32.r_1.0.S_greedytigs.k_31.d_na.M_ones.C_xz
spneumo_pangenome_k32	1.0	greedytigs	31	na	runsapprox	bzip	9627755	12822370	10921945	1900425	64917	64917	12822370	2312300	2245088	88875	2333963	2661292	spneumo_pangenome_k32.r_1.0.S_greedytigs.k_31.d_na.M_runsapprox.C_bzip
spneumo_pangenome_k32	1.0	greedytigs	31	na	runsapprox	xz	9627755	12822370	10921945	1900425	64917	64917	12822370	2312300	2245088	172704	2417792	2661292	spneumo_pangenome_k32.r_1.0.S_greedytigs.k_31.d_na.M_runsapprox.C_xz
spneumo_pangenome_k32	0.000000001	matchtigs	31	na	default	bzip	1	31	1	30	1	1	31	96	96	41	137	96	spneumo_pangenome_k32.r_0.000000001.S_matchtigs.k_31.d_na.M_default.C_bzip
spneumo_pangenome_k32	0.000000001	matchtigs	31	na	default	xz	1	31	1	30	1	1	31	96	96	76	172	96	spneumo_pangenome_k32.r_0.000000001.S_matchtigs.k_31.d_na.M_default.C_xz
spneumo_pangenome_k32	0.000000001	matchtigs	31	na	ones	bzip	1	31	1	30	1	1	31	96	96	41	137	96	spneumo_pangenome_k32.r_0.000000001.S_matchtigs.k_31.d_na.M_ones.C_bzip
spneumo_pangenome_k32	0.000000001	matchtigs	31	na	ones	xz	1	31	1	30	1	1	31	96	96	76	172	96	spneumo_pangenome_k32.r_0.000000001.S_matchtigs.k_31.d_na.M_ones.C_xz
spneumo_pangenome_k32	0.000000001	matchtigs	31	na	runsapprox	bzip	1	31	1	30	1	1	31	96	96	41	137	96	spneumo_pangenome_k32.r_0.000000001.S_matchtigs.k_31.d_na.M_runsapprox.C_bzip
spneumo_pangenome_k32	0.000000001	matchtigs	31	na	runsapprox	xz	1	31	1	30	1	1	31	96	96	76	172	96	spneumo_pangenome_k32.r_0.000000001.S_matchtigs.k_31.d_na.M_runsapprox.C_xz
spneumo_pangenome_k32	0.0001	matchtigs	31	na	default	bzip	962	29822	962	28860	962	962	29822	8684	8348	47	8395	8732	spneumo_pangenome_k32.r_0.0001.S_matchtigs.k_31.d_na.M_default.C_bzip
spneumo_pangenome_k32	0.0001	matchtigs	31	na	default	xz	962	29822	962	28860	962	962	29822	8684	8348	144	8492	8732	spneumo_pangenome_k32.r_0.0001.S_matchtigs.k_31.d_na.M_default.C_xz
spneumo_pangenome_k32	0.0001	matchtigs	31	na	ones	bzip	962	29822	962	28860	962	962	29822	8684	8348	47	8395	8732	spneumo_pangenome_k32.r_0.0001.S_matchtigs.k_31.d_na.M_ones.C_bzip
spneumo_pangenome_k32	0.0001	matchtigs	31	na	ones	xz	962	29822	962	28860	962	962	29822	8684	8348	144	8492	8732	spneumo_pangenome_k32.r_0.0001.S_matchtigs.k_31.d_na.M_ones.C_xz
spneumo_pangenome_k32	0.0001	matchtigs	31	na	runsapprox	bzip	962	29822	962	28860	962	962	29822	8684	8348	47	8395	8732	spneumo_pangenome_k32.r_0.0001.S_matchtigs.k_31.d_na.M_runsapprox.C_bzip
spneumo_pangenome_k32	0.0001	matchtigs	31	na	runsapprox	xz	962	29822	962	28860	962	962	29822	8684	8348	144	8492	8732	spneumo_pangenome_k32.r_0.0001.S_matchtigs.k_31.d_na.M_runsapprox.C_xz
spneumo_pangenome_k32	0.001	matchtigs	31	na	default	bzip	9627	298107	9627	288480	9616	9616	298107	83812	79604	71	79675	85684	spneumo_pangenome_k32.r_0.001.S_matchtigs.k_31.d_na.M_default.C_bzip
spneumo_pangenome_k32	0.001	matchtigs	31	na	default	xz	9627	298107	9627	288480	9616	9616	298107	83812	79604	236	79840	85684	spneumo_pangenome_k32.r_0.001.S_matchtigs.k_31.d_na.M_default.C_xz
spneumo_pangenome_k32	0.001	matchtigs	31	na	ones	bzip	9627	298107	9628	288479	9617	9616	298107	83812	79604	75	79679	85688	spneumo_pangenome_k32.r_0.001.S_matchtigs.k_31.d_na.M_ones.C_bzip
spneumo_pangenome_k32	0.001	matchtigs	31	na	ones	xz	9627	298107	9628	288479	9617	9616	298107	83812	79604	244	79848	85688	spneumo_pangenome_k32.r_0.001.S_matchtigs.k_31.d_na.M_ones.C_xz
spneumo_pangenome_k32	0.001	matchtigs	31	na	runsapprox	bzip	9627	298107	9628	288479	9617	9616	298107	83812	79604	75	79679	85688	spneumo_pangenome_k32.r_0.001.S_matchtigs.k_31.d_na.M_runsapprox.C_bzip
spneumo_pangenome_k32	0.001	matchtigs	31	na	runsapprox	xz	9627	298107	9628	288479	9617	9616	298107	83812	79604	244	79848	85688	spneumo_pangenome_k32.r_0.001.S_matchtigs.k_31.d_na.M_runsapprox.C_xz
spneumo_pangenome_k32	0.01	matchtigs	31	na	default	bzip	96277	2954527	96277	2858250	95275	95275	2954527	812852	742576	1781	744357	824968	spneumo_pangenome_k32.r_0.01.S_matchtigs.k_31.d_na.M_default.C_bzip
spneumo_pangenome_k32	0.01	matchtigs	31	na	default	xz	96277	2954527	96277	2858250	95275	95275	2954527	812852	742576	3520	746096	824968	spneumo_pangenome_k32.r_0.01.S_matchtigs.k_31.d_na.M_default.C_xz
spneumo_pangenome_k32	0.01	matchtigs	31	na	ones	bzip	96277	2954527	96506	2858021	95504	95275	2954527	812852	742576	2245	744821	824932	spneumo_pangenome_k32.r_0.01.S_matchtigs.k_31.d_na.M_ones.C_bzip
spneumo_pangenome_k32	0.01	matchtigs	31	na	ones	xz	96277	2954527	96506	2858021	95504	95275	2954527	812852	742576	4704	747280	824932	spneumo_pangenome_k32.r_0.01.S_matchtigs.k_31.d_na.M_ones.C_xz
spneumo_pangenome_k32	0.01	matchtigs	31	na	runsapprox	bzip	96277	2954527	96506	2858021	95504	95275	2954527	812852	742576	2245	744821	824932	spneumo_pangenome_k32.r_0.01.S_matchtigs.k_31.d_na.M_runsapprox.C_bzip
spneumo_pangenome_k32	0.01	matchtigs	31	na	runsapprox	xz	96277	2954527	96506	2858021	95504	95275	2954527	812852	742576	4704	747280	824932	spneumo_pangenome_k32.r_0.01.S_matchtigs.k_31.d_na.M_runsapprox.C_xz
spneumo_pangenome_k32	0.05	matchtigs	31	na	default	bzip	481387	14184937	481387	13703550	456785	456785	14184937	3563072	3230760	29158	3259918	3641564	spneumo_pangenome_k32.r_0.05.S_matchtigs.k_31.d_na.M_default.C_bzip
spneumo_pangenome_k32	0.05	matchtigs	31	na	default	xz	481387	14184937	481387	13703550	456785	456785	14184937	3563072	3230760	53184	3283944	3641564	spneumo_pangenome_k32.r_0.05.S_matchtigs.k_31.d_na.M_default.C_xz
spneumo_pangenome_k32	0.05	matchtigs	31	na	ones	bzip	481387	14184937	486049	13698888	461353	456785	14184937	3563072	3230760	36792	3267552	3645856	spneumo_pangenome_k32.r_0.05.S_matchtigs.k_31.d_na.M_ones.C_bzip
spneumo_pangenome_k32	0.05	matchtigs	31	na	ones	xz	481387	14184937	486049	13698888	461353	456785	14184937	3563072	3230760	71296	3302056	3645856	spneumo_pangenome_k32.r_0.05.S_matchtigs.k_31.d_na.M_ones.C_xz
spneumo_pangenome_k32	0.05	matchtigs	31	na	runsapprox	bzip	481387	14184937	486049	13698888	461353	456785	14184937	3563072	3230760	36792	3267552	3645856	spneumo_pangenome_k32.r_0.05.S_matchtigs.k_31.d_na.M_runsapprox.C_bzip
spneumo_pangenome_k32	0.05	matchtigs	31	na	runsapprox	xz	481387	14184937	486049	13698888	461353	456785	14184937	3563072	3230760	71296	3302056	3645856	spneumo_pangenome_k32.r_0.05.S_matchtigs.k_31.d_na.M_runsapprox.C_xz
spneumo_pangenome_k32	0.1	matchtigs	31	na	default	bzip	962775	26912655	962775	25949880	864996	864996	26912655	6311024	5728700	87989	5816689	6505668	spneumo_pangenome_k32.r_0.1.S_matchtigs.k_31.d_na.M_default.C_bzip
spneumo_pangenome_k32	0.1	matchtigs	31	na	default	xz	962775	26912655	962775	25949880	864996	864996	26912655	6311024	5728700	163252	5891952	6505668	spneumo_pangenome_k32.r_0.1.S_matchtigs.k_31.d_na.M_default.C_xz
spneumo_pangenome_k32	0.1	matchtigs	31	na	ones	bzip	962775	26912655	980395	25932260	882071	864996	26912655	6311024	5728700	113479	5842179	6519896	spneumo_pangenome_k32.r_0.1.S_matchtigs.k_31.d_na.M_ones.C_bzip
spneumo_pangenome_k32	0.1	matchtigs	31	na	ones	xz	962775	26912655	980395	25932260	882071	864996	26912655	6311024	5728700	220384	5949084	6519896	spneumo_pangenome_k32.r_0.1.S_matchtigs.k_31.d_na.M_ones.C_xz
spneumo_pangenome_k32	0.1	matchtigs	31	na	runsapprox	bzip	962775	26912655	980395	25932260	882071	864996	26912655	6311024	5728700	113479	5842179	6519896	spneumo_pangenome_k32.r_0.1.S_matchtigs.k_31.d_na.M_runsapprox.C_bzip
spneumo_pangenome_k32	0.1	matchtigs	31	na	runsapprox	xz	962775	26912655	980395	25932260	882071	864996	26912655	6311024	5728700	220384	5949084	6519896	spneumo_pangenome_k32.r_0.1.S_matchtigs.k_31.d_na.M_runsapprox.C_xz
spneumo_pangenome_k32	0.2	matchtigs	31	na	default	bzip	1925551	48017491	1925551	46091940	1536398	1536398	48017491	10488384	9534256	246876	9781132	10967240	spneumo_pangenome_k32.r_0.2.S_matchtigs.k_31.d_na.M_default.C_bzip
spneumo_pangenome_k32	0.2	matchtigs	31	na	default	xz	1925551	48017491	1925551	46091940	1536398	1536398	48017491	10488384	9534256	456072	9990328	10967240	spneumo_pangenome_k32.r_0.2.S_matchtigs.k_31.d_na.M_default.C_xz
spneumo_pangenome_k32	0.2	matchtigs	31	na	ones	bzip	1925551	48017491	1988371	46029120	1594947	1536398	48017491	10488384	9534256	326511	9860767	11022216	spneumo_pangenome_k32.r_0.2.S_matchtigs.k_31.d_na.M_ones.C_bzip
spneumo_pangenome_k32	0.2	matchtigs	31	na	ones	xz	1925551	48017491	1988371	46029120	1594947	1536398	48017491	10488384	9534256	614168	10148424	11022216	spneumo_pangenome_k32.r_0.2.S_matchtigs.k_31.d_na.M_ones.C_xz
spneumo_pangenome_k32	0.2	matchtigs	31	na	runsapprox	bzip	1925551	48017491	1988371	46029120	1594947	1536398	48017491	10488384	9534256	326511	9860767	11022216	spneumo_pangenome_k32.r_0.2.S_matchtigs.k_31.d_na.M_runsapprox.C_bzip
spneumo_pangenome_k32	0.2	matchtigs	31	na	runsapprox	xz	1925551	48017491	1988371	46029120	1594947	1536398	48017491	10488384	9534256	614168	10148424	11022216	spneumo_pangenome_k32.r_0.2.S_matchtigs.k_31.d_na.M_runsapprox.C_xz
spneumo_pangenome_k32	0.3	matchtigs	31	na	default	bzip	2888326	63375617	2888327	60487290	2016243	2016243	63375617	13320800	12085632	434291	12519923	14135200	spneumo_pangenome_k32.r_0.3.S_matchtigs.k_31.d_na.M_default.C_bzip
spneumo_pangenome_k32	0.3	matchtigs	31	na	default	xz	2888326	63375617	2888327	60487290	2016243	2016243	63375617	13320800	12085632	791912	12877544	14135200	spneumo_pangenome_k32.r_0.3.S_matchtigs.k_31.d_na.M_default.C_xz
spneumo_pangenome_k32	0.3	matchtigs	31	na	ones	bzip	2888326	63375617	3013181	60362436	2128251	2016243	63375617	13320800	12085632	581234	12666866	14243688	spneumo_pangenome_k32.r_0.3.S_matchtigs.k_31.d_na.M_ones.C_bzip
spneumo_pangenome_k32	0.3	matchtigs	31	na	ones	xz	2888326	63375617	3013181	60362436	2128251	2016243	63375617	13320800	12085632	1052160	13137792	14243688	spneumo_pangenome_k32.r_0.3.S_matchtigs.k_31.d_na.M_ones.C_xz
spneumo_pangenome_k32	0.3	matchtigs	31	na	runsapprox	bzip	2888326	63375617	3013181	60362436	2128251	2016243	63375617	13320800	12085632	581234	12666866	14243688	spneumo_pangenome_k32.r_0.3.S_matchtigs.k_31.d_na.M_runsapprox.C_bzip
spneumo_pangenome_k32	0.3	matchtigs	31	na	runsapprox	xz	2888326	63375617	3013181	60362436	2128251	2016243	63375617	13320800	12085632	1052160	13137792	14243688	spneumo_pangenome_k32.r_0.3.S_matchtigs.k_31.d_na.M_runsapprox.C_xz
spneumo_pangenome_k32	0.4	matchtigs	31	na	default	bzip	3851102	73031778	3851118	69180660	2306022	2306022	73031778	15040788	13632376	624913	14257289	16173792	spneumo_pangenome_k32.r_0.4.S_matchtigs.k_31.d_na.M_default.C_bzip
spneumo_pangenome_k32	0.4	matchtigs	31	na	default	xz	3851102	73031778	3851118	69180660	2306022	2306022	73031778	15040788	13632376	1124104	14756480	16173792	spneumo_pangenome_k32.r_0.4.S_matchtigs.k_31.d_na.M_default.C_xz
spneumo_pangenome_k32	0.4	matchtigs	31	na	ones	bzip	3851102	73031778	4042334	68989444	2470162	2306022	73031778	15040788	13632376	839171	14471547	16340652	spneumo_pangenome_k32.r_0.4.S_matchtigs.k_31.d_na.M_ones.C_bzip
spneumo_pangenome_k32	0.4	matchtigs	31	na	ones	xz	3851102	73031778	4042334	68989444	2470162	2306022	73031778	15040788	13632376	1461288	15093664	16340652	spneumo_pangenome_k32.r_0.4.S_matchtigs.k_31.d_na.M_ones.C_xz
spneumo_pangenome_k32	0.4	matchtigs	31	na	runsapprox	bzip	3851102	73031778	4042334	68989444	2470162	2306022	73031778	15040788	13632376	839171	14471547	16340652	spneumo_pangenome_k32.r_0.4.S_matchtigs.k_31.d_na.M_runsapprox.C_bzip
spneumo_pangenome_k32	0.4	matchtigs	31	na	runsapprox	xz	3851102	73031778	4042334	68989444	2470162	2306022	73031778	15040788	13632376	1461288	15093664	16340652	spneumo_pangenome_k32.r_0.4.S_matchtigs.k_31.d_na.M_runsapprox.C_xz
spneumo_pangenome_k32	0.5	matchtigs	31	na	default	bzip	4813877	77016980	4813940	72203040	2406768	2406768	77016980	15721628	14276320	794879	15071199	17156288	spneumo_pangenome_k32.r_0.5.S_matchtigs.k_31.d_na.M_default.C_bzip
spneumo_pangenome_k32	0.5	matchtigs	31	na	default	xz	4813877	77016980	4813940	72203040	2406768	2406768	77016980	15721628	14276320	1412200	15688520	17156288	spneumo_pangenome_k32.r_0.5.S_matchtigs.k_31.d_na.M_default.C_xz
spneumo_pangenome_k32	0.5	matchtigs	31	na	ones	bzip	4813877	77016980	5067131	71949849	2614119	2406768	77016980	15721628	14276320	1068273	15344593	17380356	spneumo_pangenome_k32.r_0.5.S_matchtigs.k_31.d_na.M_ones.C_bzip
spneumo_pangenome_k32	0.5	matchtigs	31	na	ones	xz	4813877	77016980	5067131	71949849	2614119	2406768	77016980	15721628	14276320	1791092	16067412	17380356	spneumo_pangenome_k32.r_0.5.S_matchtigs.k_31.d_na.M_ones.C_xz
spneumo_pangenome_k32	0.5	matchtigs	31	na	runsapprox	bzip	4813877	77016980	5067131	71949849	2614119	2406768	77016980	15721628	14276320	1068273	15344593	17380356	spneumo_pangenome_k32.r_0.5.S_matchtigs.k_31.d_na.M_runsapprox.C_bzip
spneumo_pangenome_k32	0.5	matchtigs	31	na	runsapprox	xz	4813877	77016980	5067131	71949849	2614119	2406768	77016980	15721628	14276320	1791092	16067412	17380356	spneumo_pangenome_k32.r_0.5.S_matchtigs.k_31.d_na.M_runsapprox.C_xz
spneumo_pangenome_k32	0.6	matchtigs	31	na	default	bzip	5776653	75437415	5776935	69660480	2322016	2322016	75437415	15368668	13936272	918095	14854367	17083752	spneumo_pangenome_k32.r_0.6.S_matchtigs.k_31.d_na.M_default.C_bzip
spneumo_pangenome_k32	0.6	matchtigs	31	na	default	xz	5776653	75437415	5776935	69660480	2322016	2322016	75437415	15368668	13936272	1605364	15541636	17083752	spneumo_pangenome_k32.r_0.6.S_matchtigs.k_31.d_na.M_default.C_xz
spneumo_pangenome_k32	0.6	matchtigs	31	na	ones	bzip	5776653	75437415	6074020	69363395	2551551	2322016	75437415	15368668	13936272	1227458	15163730	17344500	spneumo_pangenome_k32.r_0.6.S_matchtigs.k_31.d_na.M_ones.C_bzip
spneumo_pangenome_k32	0.6	matchtigs	31	na	ones	xz	5776653	75437415	6074020	69363395	2551551	2322016	75437415	15368668	13936272	1986052	15922324	17344500	spneumo_pangenome_k32.r_0.6.S_matchtigs.k_31.d_na.M_ones.C_xz
spneumo_pangenome_k32	0.6	matchtigs	31	na	runsapprox	bzip	5776653	75437415	6074020	69363395	2551551	2322016	75437415	15368668	13936272	1227458	15163730	17344500	spneumo_pangenome_k32.r_0.6.S_matchtigs.k_31.d_na.M_runsapprox.C_bzip
spneumo_pangenome_k32	0.6	matchtigs	31	na	runsapprox	xz	5776653	75437415	6074020	69363395	2551551	2322016	75437415	15368668	13936272	1986052	15922324	17344500	spneumo_pangenome_k32.r_0.6.S_matchtigs.k_31.d_na.M_runsapprox.C_xz
spneumo_pangenome_k32	0.7	matchtigs	31	na	default	bzip	6739428	68345018	6741218	61603800	2053460	2053460	68345018	13990996	12778432	955940	13734372	15924392	spneumo_pangenome_k32.r_0.7.S_matchtigs.k_31.d_na.M_default.C_bzip
spneumo_pangenome_k32	0.7	matchtigs	31	na	default	xz	6739428	68345018	6741218	61603800	2053460	2053460	68345018	13990996	12778432	1649140	14427572	15924392	spneumo_pangenome_k32.r_0.7.S_matchtigs.k_31.d_na.M_default.C_xz
spneumo_pangenome_k32	0.7	matchtigs	31	na	ones	bzip	6739428	68345018	7060229	61284789	2280943	2053460	68345018	13990996	12778432	1275407	14053839	16199856	spneumo_pangenome_k32.r_0.7.S_matchtigs.k_31.d_na.M_ones.C_bzip
spneumo_pangenome_k32	0.7	matchtigs	31	na	ones	xz	6739428	68345018	7060229	61284789	2280943	2053460	68345018	13990996	12778432	1998824	14777256	16199856	spneumo_pangenome_k32.r_0.7.S_matchtigs.k_31.d_na.M_ones.C_xz
spneumo_pangenome_k32	0.7	matchtigs	31	na	runsapprox	bzip	6739428	68345018	7060229	61284789	2280943	2053460	68345018	13990996	12778432	1275407	14053839	16199856	spneumo_pangenome_k32.r_0.7.S_matchtigs.k_31.d_na.M_runsapprox.C_bzip
spneumo_pangenome_k32	0.7	matchtigs	31	na	runsapprox	xz	6739428	68345018	7060229	61284789	2280943	2053460	68345018	13990996	12778432	1998824	14777256	16199856	spneumo_pangenome_k32.r_0.7.S_matchtigs.k_31.d_na.M_runsapprox.C_xz
spneumo_pangenome_k32	0.8	matchtigs	31	na	default	bzip	7702204	55712691	7711731	48000960	1600032	1600032	55712691	11538736	10551996	876372	11428368	13565360	spneumo_pangenome_k32.r_0.8.S_matchtigs.k_31.d_na.M_default.C_bzip
spneumo_pangenome_k32	0.8	matchtigs	31	na	default	xz	7702204	55712691	7711731	48000960	1600032	1600032	55712691	11538736	10551996	1486112	12038108	13565360	spneumo_pangenome_k32.r_0.8.S_matchtigs.k_31.d_na.M_default.C_xz
spneumo_pangenome_k32	0.8	matchtigs	31	na	ones	bzip	7702204	55712691	8010431	47702260	1790349	1600032	55712691	11538736	10551996	1160498	11712494	13818380	spneumo_pangenome_k32.r_0.8.S_matchtigs.k_31.d_na.M_ones.C_bzip
spneumo_pangenome_k32	0.8	matchtigs	31	na	ones	xz	7702204	55712691	8010431	47702260	1790349	1600032	55712691	11538736	10551996	1772564	12324560	13818380	spneumo_pangenome_k32.r_0.8.S_matchtigs.k_31.d_na.M_ones.C_xz
spneumo_pangenome_k32	0.8	matchtigs	31	na	runsapprox	bzip	7702204	55712691	8010431	47702260	1790349	1600032	55712691	11538736	10551996	1160498	11712494	13818380	spneumo_pangenome_k32.r_0.8.S_matchtigs.k_31.d_na.M_runsapprox.C_bzip
spneumo_pangenome_k32	0.8	matchtigs	31	na	runsapprox	xz	7702204	55712691	8010431	47702260	1790349	1600032	55712691	11538736	10551996	1772564	12324560	13818380	spneumo_pangenome_k32.r_0.8.S_matchtigs.k_31.d_na.M_runsapprox.C_xz
spneumo_pangenome_k32	0.9	matchtigs	31	na	default	bzip	8664979	37450984	8727364	28723620	957454	957454	37450984	7883552	7232120	632528	7864648	9707036	spneumo_pangenome_k32.r_0.9.S_matchtigs.k_31.d_na.M_default.C_bzip
spneumo_pangenome_k32	0.9	matchtigs	31	na	default	xz	8664979	37450984	8727364	28723620	957454	957454	37450984	7883552	7232120	1044236	8276356	9707036	spneumo_pangenome_k32.r_0.9.S_matchtigs.k_31.d_na.M_default.C_xz
spneumo_pangenome_k32	0.9	matchtigs	31	na	ones	bzip	8664979	37450984	8954249	28496735	1073310	957454	37450984	7883552	7232120	833348	8065468	9872620	spneumo_pangenome_k32.r_0.9.S_matchtigs.k_31.d_na.M_ones.C_bzip
spneumo_pangenome_k32	0.9	matchtigs	31	na	ones	xz	8664979	37450984	8954249	28496735	1073310	957454	37450984	7883552	7232120	1240192	8472312	9872620	spneumo_pangenome_k32.r_0.9.S_matchtigs.k_31.d_na.M_ones.C_xz
spneumo_pangenome_k32	0.9	matchtigs	31	na	runsapprox	bzip	8664979	37450984	8954249	28496735	1073310	957454	37450984	7883552	7232120	833348	8065468	9872620	spneumo_pangenome_k32.r_0.9.S_matchtigs.k_31.d_na.M_runsapprox.C_bzip
spneumo_pangenome_k32	0.9	matchtigs	31	na	runsapprox	xz	8664979	37450984	8954249	28496735	1073310	957454	37450984	7883552	7232120	1240192	8472312	9872620	spneumo_pangenome_k32.r_0.9.S_matchtigs.k_31.d_na.M_runsapprox.C_xz
spneumo_pangenome_k32	1.0	matchtigs	31	na	default	bzip	9627755	12605708	10525208	2080500	69350	69350	12605708	2326400	2255692	76312	2332004	2686660	spneumo_pangenome_k32.r_1.0.S_matchtigs.k_31.d_na.M_default.C_bzip
spneumo_pangenome_k32	1.0	matchtigs	31	na	default	xz	9627755	12605708	10525208	2080500	69350	69350	12605708	2326400	2255692	156916	2412608	2686660	spneumo_pangenome_k32.r_1.0.S_matchtigs.k_31.d_na.M_default.C_xz
spneumo_pangenome_k32	1.0	matchtigs	31	na	ones	bzip	9627755	12605708	10575452	2030256	69391	69350	12605708	2326400	2255692	93729	2349421	2686748	spneumo_pangenome_k32.r_1.0.S_matchtigs.k_31.d_na.M_ones.C_bzip
spneumo_pangenome_k32	1.0	matchtigs	31	na	ones	xz	9627755	12605708	10575452	2030256	69391	69350	12605708	2326400	2255692	179504	2435196	2686748	spneumo_pangenome_k32.r_1.0.S_matchtigs.k_31.d_na.M_ones.C_xz
spneumo_pangenome_k32	1.0	matchtigs	31	na	runsapprox	bzip	9627755	12605708	10575452	2030256	69391	69350	12605708	2326400	2255692	93729	2349421	2686748	spneumo_pangenome_k32.r_1.0.S_matchtigs.k_31.d_na.M_runsapprox.C_bzip
spneumo_pangenome_k32	1.0	matchtigs	31	na	runsapprox	xz	9627755	12605708	10575452	2030256	69391	69350	12605708	2326400	2255692	179504	2435196	2686748	spneumo_pangenome_k32.r_1.0.S_matchtigs.k_31.d_na.M_runsapprox.C_xz
spneumo_pangenome_k32	0.000000001	prophasm	31	na	default	bzip	1	31	1	30	1	1	31	96	96	41	137	96	spneumo_pangenome_k32.r_0.000000001.S_prophasm.k_31.d_na.M_default.C_bzip
spneumo_pangenome_k32	0.000000001	prophasm	31	na	default	xz	1	31	1	30	1	1	31	96	96	76	172	96	spneumo_pangenome_k32.r_0.000000001.S_prophasm.k_31.d_na.M_default.C_xz
spneumo_pangenome_k32	0.000000001	prophasm	31	na	ones	bzip	1	31	1	30	1	1	31	96	96	41	137	96	spneumo_pangenome_k32.r_0.000000001.S_prophasm.k_31.d_na.M_ones.C_bzip
spneumo_pangenome_k32	0.000000001	prophasm	31	na	ones	xz	1	31	1	30	1	1	31	96	96	76	172	96	spneumo_pangenome_k32.r_0.000000001.S_prophasm.k_31.d_na.M_ones.C_xz
spneumo_pangenome_k32	0.000000001	prophasm	31	na	runsapprox	bzip	1	31	1	30	1	1	31	96	96	41	137	96	spneumo_pangenome_k32.r_0.000000001.S_prophasm.k_31.d_na.M_runsapprox.C_bzip
spneumo_pangenome_k32	0.000000001	prophasm	31	na	runsapprox	xz	1	31	1	30	1	1	31	96	96	76	172	96	spneumo_pangenome_k32.r_0.000000001.S_prophasm.k_31.d_na.M_runsapprox.C_xz
spneumo_pangenome_k32	0.0001	prophasm	31	na	default	bzip	962	29822	962	28860	962	962	29822	9208	8508	47	8555	9408	spneumo_pangenome_k32.r_0.0001.S_prophasm.k_31.d_na.M_default.C_bzip
spneumo_pangenome_k32	0.0001	prophasm	31	na	default	xz	962	29822	962	28860	962	962	29822	9208	8508	144	8652	9408	spneumo_pangenome_k32.r_0.0001.S_prophasm.k_31.d_na.M_default.C_xz
spneumo_pangenome_k32	0.0001	prophasm	31	na	ones	bzip	962	29822	962	28860	962	962	29822	9208	8508	47	8555	9408	spneumo_pangenome_k32.r_0.0001.S_prophasm.k_31.d_na.M_ones.C_bzip
spneumo_pangenome_k32	0.0001	prophasm	31	na	ones	xz	962	29822	962	28860	962	962	29822	9208	8508	144	8652	9408	spneumo_pangenome_k32.r_0.0001.S_prophasm.k_31.d_na.M_ones.C_xz
spneumo_pangenome_k32	0.0001	prophasm	31	na	runsapprox	bzip	962	29822	962	28860	962	962	29822	9208	8508	47	8555	9408	spneumo_pangenome_k32.r_0.0001.S_prophasm.k_31.d_na.M_runsapprox.C_bzip
spneumo_pangenome_k32	0.0001	prophasm	31	na	runsapprox	xz	962	29822	962	28860	962	962	29822	9208	8508	144	8652	9408	spneumo_pangenome_k32.r_0.0001.S_prophasm.k_31.d_na.M_runsapprox.C_xz
spneumo_pangenome_k32	0.001	prophasm	31	na	default	bzip	9627	298107	9627	288480	9616	9616	298107	86720	79916	71	79987	88300	spneumo_pangenome_k32.r_0.001.S_prophasm.k_31.d_na.M_default.C_bzip
spneumo_pangenome_k32	0.001	prophasm	31	na	default	xz	9627	298107	9627	288480	9616	9616	298107	86720	79916	240	80156	88300	spneumo_pangenome_k32.r_0.001.S_prophasm.k_31.d_na.M_default.C_xz
spneumo_pangenome_k32	0.001	prophasm	31	na	ones	bzip	9627	298107	9628	288479	9617	9616	298107	86720	79916	76	79992	88300	spneumo_pangenome_k32.r_0.001.S_prophasm.k_31.d_na.M_ones.C_bzip
spneumo_pangenome_k32	0.001	prophasm	31	na	ones	xz	9627	298107	9628	288479	9617	9616	298107	86720	79916	248	80164	88300	spneumo_pangenome_k32.r_0.001.S_prophasm.k_31.d_na.M_ones.C_xz
spneumo_pangenome_k32	0.001	prophasm	31	na	runsapprox	bzip	9627	298107	9628	288479	9617	9616	298107	86720	79916	76	79992	88300	spneumo_pangenome_k32.r_0.001.S_prophasm.k_31.d_na.M_runsapprox.C_bzip
spneumo_pangenome_k32	0.001	prophasm	31	na	runsapprox	xz	9627	298107	9628	288479	9617	9616	298107	86720	79916	248	80164	88300	spneumo_pangenome_k32.r_0.001.S_prophasm.k_31.d_na.M_runsapprox.C_xz
spneumo_pangenome_k32	0.01	prophasm	31	na	default	bzip	96277	2954527	96277	2858250	95275	95275	2954527	819800	748160	1763	749923	832408	spneumo_pangenome_k32.r_0.01.S_prophasm.k_31.d_na.M_default.C_bzip
spneumo_pangenome_k32	0.01	prophasm	31	na	default	xz	96277	2954527	96277	2858250	95275	95275	2954527	819800	748160	3416	751576	832408	spneumo_pangenome_k32.r_0.01.S_prophasm.k_31.d_na.M_default.C_xz
spneumo_pangenome_k32	0.01	prophasm	31	na	ones	bzip	96277	2954527	96467	2858060	95465	95275	2954527	819800	748160	2154	750314	832608	spneumo_pangenome_k32.r_0.01.S_prophasm.k_31.d_na.M_ones.C_bzip
spneumo_pangenome_k32	0.01	prophasm	31	na	ones	xz	96277	2954527	96467	2858060	95465	95275	2954527	819800	748160	4392	752552	832608	spneumo_pangenome_k32.r_0.01.S_prophasm.k_31.d_na.M_ones.C_xz
spneumo_pangenome_k32	0.01	prophasm	31	na	runsapprox	bzip	96277	2954527	96467	2858060	95465	95275	2954527	819800	748160	2154	750314	832608	spneumo_pangenome_k32.r_0.01.S_prophasm.k_31.d_na.M_runsapprox.C_bzip
spneumo_pangenome_k32	0.01	prophasm	31	na	runsapprox	xz	96277	2954527	96467	2858060	95465	95275	2954527	819800	748160	4392	752552	832608	spneumo_pangenome_k32.r_0.01.S_prophasm.k_31.d_na.M_runsapprox.C_xz
spneumo_pangenome_k32	0.05	prophasm	31	na	default	bzip	481387	14184937	481387	13703550	456785	456785	14184937	3599448	3280080	27380	3307460	3682004	spneumo_pangenome_k32.r_0.05.S_prophasm.k_31.d_na.M_default.C_bzip
spneumo_pangenome_k32	0.05	prophasm	31	na	default	xz	481387	14184937	481387	13703550	456785	456785	14184937	3599448	3280080	50388	3330468	3682004	spneumo_pangenome_k32.r_0.05.S_prophasm.k_31.d_na.M_default.C_xz
spneumo_pangenome_k32	0.05	prophasm	31	na	ones	bzip	481387	14184937	486253	13698684	461584	456785	14184937	3599448	3280080	35450	3315530	3685068	spneumo_pangenome_k32.r_0.05.S_prophasm.k_31.d_na.M_ones.C_bzip
spneumo_pangenome_k32	0.05	prophasm	31	na	ones	xz	481387	14184937	486253	13698684	461584	456785	14184937	3599448	3280080	69340	3349420	3685068	spneumo_pangenome_k32.r_0.05.S_prophasm.k_31.d_na.M_ones.C_xz
spneumo_pangenome_k32	0.05	prophasm	31	na	runsapprox	bzip	481387	14184937	486253	13698684	461584	456785	14184937	3599448	3280080	35450	3315530	3685068	spneumo_pangenome_k32.r_0.05.S_prophasm.k_31.d_na.M_runsapprox.C_bzip
spneumo_pangenome_k32	0.05	prophasm	31	na	runsapprox	xz	481387	14184937	486253	13698684	461584	456785	14184937	3599448	3280080	69340	3349420	3685068	spneumo_pangenome_k32.r_0.05.S_prophasm.k_31.d_na.M_runsapprox.C_xz
spneumo_pangenome_k32	0.1	prophasm	31	na	default	bzip	962775	26912655	962775	25949880	864996	864996	26912655	6402880	5839368	82012	5921380	6599948	spneumo_pangenome_k32.r_0.1.S_prophasm.k_31.d_na.M_default.C_bzip
spneumo_pangenome_k32	0.1	prophasm	31	na	default	xz	962775	26912655	962775	25949880	864996	864996	26912655	6402880	5839368	150916	5990284	6599948	spneumo_pangenome_k32.r_0.1.S_prophasm.k_31.d_na.M_default.C_xz
spneumo_pangenome_k32	0.1	prophasm	31	na	ones	bzip	962775	26912655	981212	25931443	882817	864996	26912655	6402880	5839368	108684	5948052	6615648	spneumo_pangenome_k32.r_0.1.S_prophasm.k_31.d_na.M_ones.C_bzip
spneumo_pangenome_k32	0.1	prophasm	31	na	ones	xz	962775	26912655	981212	25931443	882817	864996	26912655	6402880	5839368	211304	6050672	6615648	spneumo_pangenome_k32.r_0.1.S_prophasm.k_31.d_na.M_ones.C_xz
spneumo_pangenome_k32	0.1	prophasm	31	na	runsapprox	bzip	962775	26912655	981212	25931443	882817	864996	26912655	6402880	5839368	108684	5948052	6615648	spneumo_pangenome_k32.r_0.1.S_prophasm.k_31.d_na.M_runsapprox.C_bzip
spneumo_pangenome_k32	0.1	prophasm	31	na	runsapprox	xz	962775	26912655	981212	25931443	882817	864996	26912655	6402880	5839368	211304	6050672	6615648	spneumo_pangenome_k32.r_0.1.S_prophasm.k_31.d_na.M_runsapprox.C_xz
spneumo_pangenome_k32	0.2	prophasm	31	na	default	bzip	1925551	48017491	1925551	46091940	1536398	1536398	48017491	10615996	9690888	229661	9920549	11106584	spneumo_pangenome_k32.r_0.2.S_prophasm.k_31.d_na.M_default.C_bzip
spneumo_pangenome_k32	0.2	prophasm	31	na	default	xz	1925551	48017491	1925551	46091940	1536398	1536398	48017491	10615996	9690888	421192	10112080	11106584	spneumo_pangenome_k32.r_0.2.S_prophasm.k_31.d_na.M_default.C_xz
spneumo_pangenome_k32	0.2	prophasm	31	na	ones	bzip	1925551	48017491	1990357	46027134	1596711	1536398	48017491	10615996	9690888	312147	10003035	11162788	spneumo_pangenome_k32.r_0.2.S_prophasm.k_31.d_na.M_ones.C_bzip
spneumo_pangenome_k32	0.2	prophasm	31	na	ones	xz	1925551	48017491	1990357	46027134	1596711	1536398	48017491	10615996	9690888	589752	10280640	11162788	spneumo_pangenome_k32.r_0.2.S_prophasm.k_31.d_na.M_ones.C_xz
spneumo_pangenome_k32	0.2	prophasm	31	na	runsapprox	bzip	1925551	48017491	1990357	46027134	1596711	1536398	48017491	10615996	9690888	312147	10003035	11162788	spneumo_pangenome_k32.r_0.2.S_prophasm.k_31.d_na.M_runsapprox.C_bzip
spneumo_pangenome_k32	0.2	prophasm	31	na	runsapprox	xz	1925551	48017491	1990357	46027134	1596711	1536398	48017491	10615996	9690888	589752	10280640	11162788	spneumo_pangenome_k32.r_0.2.S_prophasm.k_31.d_na.M_runsapprox.C_xz
spneumo_pangenome_k32	0.3	prophasm	31	na	default	bzip	2888326	63375646	2888326	60487320	2016244	2016244	63375646	13440784	12230660	402879	12633539	14261108	spneumo_pangenome_k32.r_0.3.S_prophasm.k_31.d_na.M_default.C_bzip
spneumo_pangenome_k32	0.3	prophasm	31	na	default	xz	2888326	63375646	2888326	60487320	2016244	2016244	63375646	13440784	12230660	729264	12959924	14261108	spneumo_pangenome_k32.r_0.3.S_prophasm.k_31.d_na.M_default.C_xz
spneumo_pangenome_k32	0.3	prophasm	31	na	ones	bzip	2888326	63375646	3016776	60358870	2131613	2016244	63375646	13440784	12230660	555404	12786064	14375900	spneumo_pangenome_k32.r_0.3.S_prophasm.k_31.d_na.M_ones.C_bzip
spneumo_pangenome_k32	0.3	prophasm	31	na	ones	xz	2888326	63375646	3016776	60358870	2131613	2016244	63375646	13440784	12230660	1008564	13239224	14375900	spneumo_pangenome_k32.r_0.3.S_prophasm.k_31.d_na.M_ones.C_xz
spneumo_pangenome_k32	0.3	prophasm	31	na	runsapprox	bzip	2888326	63375646	3016776	60358870	2131613	2016244	63375646	13440784	12230660	555404	12786064	14375900	spneumo_pangenome_k32.r_0.3.S_prophasm.k_31.d_na.M_runsapprox.C_bzip
spneumo_pangenome_k32	0.3	prophasm	31	na	runsapprox	xz	2888326	63375646	3016776	60358870	2131613	2016244	63375646	13440784	12230660	1008564	13239224	14375900	spneumo_pangenome_k32.r_0.3.S_prophasm.k_31.d_na.M_runsapprox.C_xz
spneumo_pangenome_k32	0.4	prophasm	31	na	default	bzip	3851102	73032032	3851102	69180930	2306031	2306031	73032032	15122676	13765648	576951	14342599	16282724	spneumo_pangenome_k32.r_0.4.S_prophasm.k_31.d_na.M_default.C_bzip
spneumo_pangenome_k32	0.4	prophasm	31	na	default	xz	3851102	73032032	3851102	69180930	2306031	2306031	73032032	15122676	13765648	1030916	14796564	16282724	spneumo_pangenome_k32.r_0.4.S_prophasm.k_31.d_na.M_default.C_xz
spneumo_pangenome_k32	0.4	prophasm	31	na	ones	bzip	3851102	73032032	4048906	68983126	2476037	2306031	73032032	15122676	13765648	800356	14566004	16460112	spneumo_pangenome_k32.r_0.4.S_prophasm.k_31.d_na.M_ones.C_bzip
spneumo_pangenome_k32	0.4	prophasm	31	na	ones	xz	3851102	73032032	4048906	68983126	2476037	2306031	73032032	15122676	13765648	1396964	15162612	16460112	spneumo_pangenome_k32.r_0.4.S_prophasm.k_31.d_na.M_ones.C_xz
spneumo_pangenome_k32	0.4	prophasm	31	na	runsapprox	bzip	3851102	73032032	4048906	68983126	2476037	2306031	73032032	15122676	13765648	800356	14566004	16460112	spneumo_pangenome_k32.r_0.4.S_prophasm.k_31.d_na.M_runsapprox.C_bzip
spneumo_pangenome_k32	0.4	prophasm	31	na	runsapprox	xz	3851102	73032032	4048906	68983126	2476037	2306031	73032032	15122676	13765648	1396964	15162612	16460112	spneumo_pangenome_k32.r_0.4.S_prophasm.k_31.d_na.M_runsapprox.C_xz
spneumo_pangenome_k32	0.5	prophasm	31	na	default	bzip	4813877	77017937	4813877	72204060	2406802	2406802	77017937	15731912	14319632	729471	15049103	17235160	spneumo_pangenome_k32.r_0.5.S_prophasm.k_31.d_na.M_default.C_bzip
spneumo_pangenome_k32	0.5	prophasm	31	na	default	xz	4813877	77017937	4813877	72204060	2406802	2406802	77017937	15731912	14319632	1283924	15603556	17235160	spneumo_pangenome_k32.r_0.5.S_prophasm.k_31.d_na.M_default.C_xz
spneumo_pangenome_k32	0.5	prophasm	31	na	ones	bzip	4813877	77017937	5074286	71943651	2619769	2406802	77017937	15731912	14319632	1011210	15330842	17459568	spneumo_pangenome_k32.r_0.5.S_prophasm.k_31.d_na.M_ones.C_bzip
spneumo_pangenome_k32	0.5	prophasm	31	na	ones	xz	4813877	77017937	5074286	71943651	2619769	2406802	77017937	15731912	14319632	1699384	16019016	17459568	spneumo_pangenome_k32.r_0.5.S_prophasm.k_31.d_na.M_ones.C_xz
spneumo_pangenome_k32	0.5	prophasm	31	na	runsapprox	bzip	4813877	77017937	5074286	71943651	2619769	2406802	77017937	15731912	14319632	1011210	15330842	17459568	spneumo_pangenome_k32.r_0.5.S_prophasm.k_31.d_na.M_runsapprox.C_bzip
spneumo_pangenome_k32	0.5	prophasm	31	na	runsapprox	xz	4813877	77017937	5074286	71943651	2619769	2406802	77017937	15731912	14319632	1699384	16019016	17459568	spneumo_pangenome_k32.r_0.5.S_prophasm.k_31.d_na.M_runsapprox.C_xz
spneumo_pangenome_k32	0.6	prophasm	31	na	default	bzip	5776653	75441153	5776653	69664500	2322150	2322150	75441153	15309512	13974584	831182	14805766	17117876	spneumo_pangenome_k32.r_0.6.S_prophasm.k_31.d_na.M_default.C_bzip
spneumo_pangenome_k32	0.6	prophasm	31	na	default	xz	5776653	75441153	5776653	69664500	2322150	2322150	75441153	15309512	13974584	1447132	15421716	17117876	spneumo_pangenome_k32.r_0.6.S_prophasm.k_31.d_na.M_default.C_xz
spneumo_pangenome_k32	0.6	prophasm	31	na	ones	bzip	5776653	75441153	6083297	69357856	2558457	2322150	75441153	15309512	13974584	1150502	15125086	17382492	spneumo_pangenome_k32.r_0.6.S_prophasm.k_31.d_na.M_ones.C_bzip
spneumo_pangenome_k32	0.6	prophasm	31	na	ones	xz	5776653	75441153	6083297	69357856	2558457	2322150	75441153	15309512	13974584	1872740	15847324	17382492	spneumo_pangenome_k32.r_0.6.S_prophasm.k_31.d_na.M_ones.C_xz
spneumo_pangenome_k32	0.6	prophasm	31	na	runsapprox	bzip	5776653	75441153	6083297	69357856	2558457	2322150	75441153	15309512	13974584	1150502	15125086	17382492	spneumo_pangenome_k32.r_0.6.S_prophasm.k_31.d_na.M_runsapprox.C_bzip
spneumo_pangenome_k32	0.6	prophasm	31	na	runsapprox	xz	5776653	75441153	6083297	69357856	2558457	2322150	75441153	15309512	13974584	1872740	15847324	17382492	spneumo_pangenome_k32.r_0.6.S_prophasm.k_31.d_na.M_runsapprox.C_xz
spneumo_pangenome_k32	0.7	prophasm	31	na	default	bzip	6739428	68362728	6739428	61623300	2054110	2054110	68362728	13862080	12654920	854564	13509484	15920976	spneumo_pangenome_k32.r_0.7.S_prophasm.k_31.d_na.M_default.C_bzip
spneumo_pangenome_k32	0.7	prophasm	31	na	default	xz	6739428	68362728	6739428	61623300	2054110	2054110	68362728	13862080	12654920	1480148	14135068	15920976	spneumo_pangenome_k32.r_0.7.S_prophasm.k_31.d_na.M_default.C_xz
spneumo_pangenome_k32	0.7	prophasm	31	na	ones	bzip	6739428	68362728	7063786	61298942	2285677	2054110	68362728	13862080	12654920	1179129	13834049	16194740	spneumo_pangenome_k32.r_0.7.S_prophasm.k_31.d_na.M_ones.C_bzip
spneumo_pangenome_k32	0.7	prophasm	31	na	ones	xz	6739428	68362728	7063786	61298942	2285677	2054110	68362728	13862080	12654920	1873820	14528740	16194740	spneumo_pangenome_k32.r_0.7.S_prophasm.k_31.d_na.M_ones.C_xz
spneumo_pangenome_k32	0.7	prophasm	31	na	runsapprox	bzip	6739428	68362728	7063786	61298942	2285677	2054110	68362728	13862080	12654920	1179129	13834049	16194740	spneumo_pangenome_k32.r_0.7.S_prophasm.k_31.d_na.M_runsapprox.C_bzip
spneumo_pangenome_k32	0.7	prophasm	31	na	runsapprox	xz	6739428	68362728	7063786	61298942	2285677	2054110	68362728	13862080	12654920	1873820	14528740	16194740	spneumo_pangenome_k32.r_0.7.S_prophasm.k_31.d_na.M_runsapprox.C_xz
spneumo_pangenome_k32	0.8	prophasm	31	na	default	bzip	7702204	55782334	7702204	48080130	1602671	1602671	55782334	11397312	10442420	773524	11215944	13556916	spneumo_pangenome_k32.r_0.8.S_prophasm.k_31.d_na.M_default.C_bzip
spneumo_pangenome_k32	0.8	prophasm	31	na	default	xz	7702204	55782334	7702204	48080130	1602671	1602671	55782334	11397312	10442420	1335804	11778224	13556916	spneumo_pangenome_k32.r_0.8.S_prophasm.k_31.d_na.M_default.C_xz
spneumo_pangenome_k32	0.8	prophasm	31	na	ones	bzip	7702204	55782334	8007374	47774960	1795554	1602671	55782334	11397312	10442420	1064523	11506943	13796620	spneumo_pangenome_k32.r_0.8.S_prophasm.k_31.d_na.M_ones.C_bzip
spneumo_pangenome_k32	0.8	prophasm	31	na	ones	xz	7702204	55782334	8007374	47774960	1795554	1602671	55782334	11397312	10442420	1660212	12102632	13796620	spneumo_pangenome_k32.r_0.8.S_prophasm.k_31.d_na.M_ones.C_xz
spneumo_pangenome_k32	0.8	prophasm	31	na	runsapprox	bzip	7702204	55782334	8007374	47774960	1795554	1602671	55782334	11397312	10442420	1064523	11506943	13796620	spneumo_pangenome_k32.r_0.8.S_prophasm.k_31.d_na.M_runsapprox.C_bzip
spneumo_pangenome_k32	0.8	prophasm	31	na	runsapprox	xz	7702204	55782334	8007374	47774960	1795554	1602671	55782334	11397312	10442420	1660212	12102632	13796620	spneumo_pangenome_k32.r_0.8.S_prophasm.k_31.d_na.M_runsapprox.C_xz
spneumo_pangenome_k32	0.9	prophasm	31	na	default	bzip	8664979	37755349	8664979	29090370	969679	969679	37755349	7793800	7157160	562246	7719406	9677928	spneumo_pangenome_k32.r_0.9.S_prophasm.k_31.d_na.M_default.C_bzip
spneumo_pangenome_k32	0.9	prophasm	31	na	default	xz	8664979	37755349	8664979	29090370	969679	969679	37755349	7793800	7157160	963184	8120344	9677928	spneumo_pangenome_k32.r_0.9.S_prophasm.k_31.d_na.M_default.C_xz
spneumo_pangenome_k32	0.9	prophasm	31	na	ones	bzip	8664979	37755349	8904549	28850800	1087055	969679	37755349	7793800	7157160	771698	7928858	9850484	spneumo_pangenome_k32.r_0.9.S_prophasm.k_31.d_na.M_ones.C_bzip
spneumo_pangenome_k32	0.9	prophasm	31	na	ones	xz	8664979	37755349	8904549	28850800	1087055	969679	37755349	7793800	7157160	1182984	8340144	9850484	spneumo_pangenome_k32.r_0.9.S_prophasm.k_31.d_na.M_ones.C_xz
spneumo_pangenome_k32	0.9	prophasm	31	na	runsapprox	bzip	8664979	37755349	8904549	28850800	1087055	969679	37755349	7793800	7157160	771698	7928858	9850484	spneumo_pangenome_k32.r_0.9.S_prophasm.k_31.d_na.M_runsapprox.C_bzip
spneumo_pangenome_k32	0.9	prophasm	31	na	runsapprox	xz	8664979	37755349	8904549	28850800	1087055	969679	37755349	7793800	7157160	1182984	8340144	9850484	spneumo_pangenome_k32.r_0.9.S_prophasm.k_31.d_na.M_runsapprox.C_xz
spneumo_pangenome_k32	1.0	prophasm	31	na	default	bzip	9627755	14382935	9627755	4755180	158506	158506	14382935	2667324	2570188	120314	2690502	3371148	spneumo_pangenome_k32.r_1.0.S_prophasm.k_31.d_na.M_default.C_bzip
spneumo_pangenome_k32	1.0	prophasm	31	na	default	xz	9627755	14382935	9627755	4755180	158506	158506	14382935	2667324	2570188	217292	2787480	3371148	spneumo_pangenome_k32.r_1.0.S_prophasm.k_31.d_na.M_default.C_xz
spneumo_pangenome_k32	1.0	prophasm	31	na	ones	bzip	9627755	14382935	9745660	4637275	158626	158506	14382935	2667324	2570188	168711	2738899	3381664	spneumo_pangenome_k32.r_1.0.S_prophasm.k_31.d_na.M_ones.C_bzip
spneumo_pangenome_k32	1.0	prophasm	31	na	ones	xz	9627755	14382935	9745660	4637275	158626	158506	14382935	2667324	2570188	278552	2848740	3381664	spneumo_pangenome_k32.r_1.0.S_prophasm.k_31.d_na.M_ones.C_xz
spneumo_pangenome_k32	1.0	prophasm	31	na	runsapprox	bzip	9627755	14382935	9745660	4637275	158626	158506	14382935	2667324	2570188	168711	2738899	3381664	spneumo_pangenome_k32.r_1.0.S_prophasm.k_31.d_na.M_runsapprox.C_bzip
spneumo_pangenome_k32	1.0	prophasm	31	na	runsapprox	xz	9627755	14382935	9745660	4637275	158626	158506	14382935	2667324	2570188	278552	2848740	3381664	spneumo_pangenome_k32.r_1.0.S_prophasm.k_31.d_na.M_runsapprox.C_xz
